manual_ID
AACCATGTCTTCCCGA	midline_cells_even
AACGGGACACATTGTG	midline_cells_even
AAGACTCAGACTTGTC	midline_cells_even
AAGATAGGTACTGCGC	midline_cells_even
AAGGTAACATCCCACT	midline_cells_even
ACACTGACAAGAAACT	midline_cells_odd
ACAGAAAGTTAGTTCG	midline_cells_odd
ACCAAACTCTGTAACG	midline_cells_even
ACGGTCGCACGTACAT	midline_cells_odd
ACGTAACCAAACGGCA	midline_cells_odd
ACGTTCCTCCACGGGT	midline_cells_odd
ACTATCTAGGTGATCG	midline_cells_even
ACTATGGTCTCCATAT	midline_cells_even
AGAAGTAAGTGCTCGC	midline_cells_odd
AGACCCGCAGGCATTT	midline_cells_even
AGATCCACAGGTCCGT	midline_cells_even
AGCGATTTCCAAGCAT	midline_cells_odd
AGCGCTGTCAGTCTTT	midline_cells_odd
AGGCATTCAACGGCTC	midline_cells_odd
AGGGCTCAGGAAGTAG	midline_cells_even
AGGGCTCCAATCTGCA	midline_cells_even
AGGTCTATCCCGTTGT	midline_cells_odd
ATACCTTTCCATGATG	midline_cells_odd
ATCAGGTCATAACGGG	midline_cells_odd
ATCCGTCCATGAATAG	midline_cells_odd
ATGATCGTCGGAGCAA	midline_cells_odd
ATGTCTTAGCGCCGTT	midline_cells_even
ATTATCCAGGTAGGCT	midline_cells_even
ATTGGGTTCAAACTGC	midline_cells_odd
ATTTCTGAGCTGCGAA	midline_cells_even
CAAGAGGTCCATTGCC	midline_cells_odd
CACACAAGTCTACACA	midline_cells_odd
CACACAAGTTATCTGG	midline_cells_odd
CACGGGTAGGCCCAAA	midline_cells_even
CAGCCAGGTGCATCTA	midline_cells_odd
CAGGTATGTTGGGCCT	midline_cells_even
CAGTTCCGTGAAAGTT	midline_cells_odd
CATAAGCAGCTGACCC	midline_cells_odd
CATCAAGAGGAGGGTG	midline_cells_even
CATCGCTCATCAGCTA	midline_cells_even
CATTGAGAGGTTGAGC	midline_cells_odd
CCATCACAGTATAGGT	midline_cells_even
CCATCACGTTGGCCGT	midline_cells_even
CCCGAAGAGAGTTGTA	midline_cells_even
CCCTAACAGCATCAAA	midline_cells_odd
CCCTTAGCATGACGAG	midline_cells_odd
CCGATGGAGGATATGT	midline_cells_odd
CCGTAGGTCTTAGGAC	midline_cells_odd
CCGTTCACAGTAACGG	midline_cells_even
CGAATTGGTCTTACTT	midline_cells_odd
CGAGTTAAGTGTAGTA	midline_cells_odd
CGCCATTCAATCGCAT	midline_cells_odd
CGCCATTCAGCGTGAA	midline_cells_odd
CGGCAGTCATCGCTAA	midline_cells_even
CGGTCAGAGCACTCTA	midline_cells_even
CGTGCTTTCGCTCTAC	midline_cells_odd
CGTTAGACACCGTCTT	midline_cells_odd
CGTTAGATCTTCCCAG	midline_cells_odd
CTATAGGCAAGGTCAG	midline_cells_even
CTATAGGTCATCGTAG	midline_cells_even
CTCCCAAAGATTTGCC	midline_cells_odd
CTCCTTTCACGGGCTT	midline_cells_odd
CTGTAGACAGACTCTA	midline_cells_odd
CTTCCGAGTTCTATCT	midline_cells_odd
CTTCCTTCATAACGGG	midline_cells_even
CTTTCGGAGAACTGAT	midline_cells_odd
CTTTCGGCAAGCGAGT	midline_cells_odd
GAAGGGTCAGTAGGAC	midline_cells_even
GACATCACACGATAGG	midline_cells_odd
GACGTTATCATGCCAA	midline_cells_even
GAGGGATAGGACATCG	midline_cells_even
GAGTCATCAAGTGACG	midline_cells_odd
GATCATGAGAGTCAAT	midline_cells_even
GATGGAGAGATAGTGT	midline_cells_even
GATGTTGGTCCAATCA	midline_cells_even
GCAGCTGAGCACACAG	midline_cells_even
GCATCGGTCGAATGCT	midline_cells_odd
GCCAACGGTGAGCAGT	midline_cells_odd
GCCGATGAGTTCATGC	midline_cells_even
GCGGAAAGTAATCAGA	midline_cells_odd
GCTACCTCAGTCAGCC	midline_cells_odd
GCTTTCGCAGCGTGCT	midline_cells_even
GCTTTCGGTTCGGCTG	midline_cells_odd
GGAAGTGGTACCATAC	midline_cells_even
GGAGAACCACAGCGCT	midline_cells_even
GGAGAACCAGCTGAAG	midline_cells_even
GGAGGATTCGGACCAC	midline_cells_odd
GGGTAGACACCCTAGG	midline_cells_odd
GGGTCACAGATGACCG	midline_cells_odd
GGGTCTGCATAACGGG	midline_cells_odd
GGTCTGGTCCACCTGT	midline_cells_even
GTAACACAGGTCCGAA	midline_cells_odd
GTAACACCACTGCGTG	midline_cells_even
GTAAGTCCAGCGTAGA	midline_cells_even
GTAGTACGTCCTTAAG	midline_cells_even
GTCGTTCAGTGTACAA	midline_cells_odd
GTGAGTTAGCGTGCTC	midline_cells_even
GTGGAGATCAAGTAAG	midline_cells_odd
TAACACGTCAGTCAGT	midline_cells_odd
TAACGACGTGGATTTC	midline_cells_even
TACAACGAGGTGATAT	midline_cells_even
TACCCACAGTTTGGCT	midline_cells_odd
TACCTGCGTGCTCTCT	midline_cells_odd
TACCTGCGTGTCCAAT	midline_cells_even
TACGGGCGTGAAAGTT	midline_cells_even
TACTTCAAGGACAGCT	midline_cells_odd
TAGTGCAAGTAGACCG	midline_cells_even
TATATCCTCCTGGGAC	midline_cells_even
TCAAGTGTCTGACGCG	midline_cells_even
TCACTCGCACCTTCCA	midline_cells_even
TCAGGGCTCAGCGCAC	midline_cells_odd
TCCATCGGTCCTGGTG	midline_cells_even
TCCGGGACAAAGACTA	midline_cells_even
TCCTTCTAGCTTCTAG	midline_cells_odd
TCGATTTCATCGTTCC	midline_cells_odd
TCGCTCACAAGTGCAG	midline_cells_odd
TCGGATAGTCGTAATC	midline_cells_odd
TCTCCGAAGGATCATA	midline_cells_even
TGAGGGACAGGACTTT	midline_cells_even
TGATGCAAGCTGAAGC	midline_cells_odd
TGGGATTCAGAAGTTA	midline_cells_even
TGTTCATAGTCTGCAT	midline_cells_even
TGTTCTACAATTGCAC	midline_cells_even
TTACCGCTCTGTTGGA	midline_cells_odd
TTAGGGTGTTTGGAGG	midline_cells_even
TTCCTAATCGCACTCT	midline_cells_even
TTCTAGTAGTGCGCTC	midline_cells_odd
TTCTTCCTCGCTCTAC	midline_cells_odd
TTGAACGTCGTGGACC	midline_cells_odd
TTGCGTCCAAGTGGAC	midline_cells_even
TTGTTCAGTACCCAGC	midline_cells_even
TTTAGTCTCAAGCGTT	midline_cells_even
TTTCACATCTCAGAAC	midline_cells_odd
TTTGGAGTCCTGGCTT	midline_cells_even
TTTGGTTTCGTCCATC	midline_cells_even
