ID
AAACCCAAGCGATCGA	endoderm_postMG_ventral
AAACGAAAGGAACGAA	ectoderm_hindgut_ventral
AAACGAACACTAGTAC	endoderm_postMG_lateral
AAACGCTAGCGAACTG	ectoderm_PS14_dorsal
AAACGCTTCCGTTGAA	ectoderm_PS14/hindgut
AAAGAACAGACATAGT	ectoderm_PS14_dorsal
AAAGGTACATTGAGGG	endoderm_postMG_ventral
AAAGGTATCTCCGATC	ectoderm_PS14/hindgut
AAAGTCCTCAAAGACA	ectoderm_hindgut_dorsal
AAAGTGATCATCCCGT	endoderm_postMG_ventral
AACAAAGTCGCTCTAC	endoderm_postMG_lateral
AACAACCAGGATGTTA	endoderm_postMG_dorsal
AACAAGACAATTGCAC	endoderm_postMG_dorsal
AACAAGACAGAGGTTG	ectoderm_PS14_ventral
AACAAGAGTTTCGACA	ectoderm_PS14_ventral
AACACACAGGATGCGT	ectoderm_PS14_ventral
AACAGGGCAGAAATCA	ectoderm_hindgut_dorsal
AACCAACAGGTGCTTT	ectoderm_PS14_ventral
AACCACATCGCCAACG	ectoderm_PS14_dorsal
AACCTGAAGAGCATCG	endoderm_postMG_dorsal
AACCTTTCAAGGACAC	endoderm_postMG_dorsal
AACGGGAAGTGGTTAA	ectoderm_PS14_dorsal
AACTTCTGTTGACTGT	ectoderm_PS14_ventral
AAGAACAAGCCTTGAT	endoderm_postMG_lateral
AAGACAACAGTGGTGA	ectoderm_PS14_dorsal
AAGATAGGTGTCCAAT	endoderm_postMG_lateral
AAGCGAGAGCTGAGTG	endoderm_postMG_ventral
AAGCGAGAGTAACGAT	ectoderm_hindgut_dorsal
AAGCGAGTCCCTTCCC	ectoderm_PS14_dorsal
AAGCGTTTCATGAGTC	ectoderm_PS14/hindgut
AAGGAATAGCTAATGA	endoderm_postMG_lateral
AAGTTCGAGGATGCGT	endoderm_postMG_dorsal
AAGTTCGGTCACGCTG	ectoderm_hindgut_dorsal
AATAGAGTCACCTTAT	endoderm_postMG_dorsal
AATCACGCAGAGTTGG	ectoderm_PS14/hindgut
AATCACGGTCGTTTCC	ectoderm_PS14_dorsal
AATCGACAGTCTGGAG	endoderm_postMG_lateral
AATCGACGTACTGGGA	ectoderm_hindgut_dorsal
AATCGACGTCTCTCTG	ectoderm_hindgut_dorsal
AATCGTGAGGGAGGGT	endoderm_postMG_dorsal
AATGCCACACGACTAT	ectoderm_hindgut_ventral
AATGGAAGTCACTTAG	endoderm_postMG_lateral
AATGGCTAGGGTATAT	ectoderm_hindgut_ventral
AATTCCTCAACTGTGT	ectoderm_PS14/hindgut
AATTTCCCAGGTTCCG	ectoderm_hindgut_ventral
ACAAAGAAGACCAAAT	ectoderm_PS14_dorsal
ACAAAGATCATGTCAG	endoderm_postMG_ventral
ACAAAGATCGAAGCAG	ectoderm_PS14_dorsal
ACAACCACACCCGTAG	ectoderm_PS14/hindgut
ACACAGTTCAGCAATC	ectoderm_PS14_ventral
ACACAGTTCTTCCCAG	ectoderm_PS14/hindgut
ACACCAAAGCGAAACC	endoderm_postMG_lateral
ACACCAAAGGGATCAC	ectoderm_PS14/hindgut
ACACGCGAGACCAGCA	endoderm_postMG_lateral
ACACTGACAATTAGGA	amnioserosa_PS14
ACAGAAAGTTCTTCAT	ectoderm_hindgut_ventral
ACAGAAAGTTTGTTGG	endoderm_postMG_dorsal
ACAGCCGTCCTTGACC	ectoderm_PS14_dorsal
ACATCCCGTCTGCATA	endoderm_postMG_ventral
ACATCCCTCATAGACC	ectoderm_hindgut_ventral
ACATTTCAGACCTTTG	ectoderm_hindgut_dorsal
ACATTTCTCTGTGCGG	ectoderm_PS14_dorsal
ACCAAACTCGTGTTCC	ectoderm_hindgut_dorsal
ACCAACAAGACCTCAT	endoderm_postMG_ventral
ACCAACATCATCCTAT	ectoderm_PS14/hindgut
ACCACAAAGCGACATG	endoderm_postMG_lateral
ACCACAAAGGCGCTCT	endoderm_postMG_lateral
ACCACAACAAATGGAT	ectoderm_hindgut_ventral
ACCATTTGTATGCGGA	endoderm_postMG_lateral
ACCCAAACAATGAAAC	endoderm_postMG_lateral
ACCCTCACACGCTGAC	endoderm_postMG_lateral
ACCCTTGAGAAACACT	endoderm_postMG_ventral
ACCTACCAGCATTGAA	endoderm_postMG_ventral
ACCTACCCAAGAGGCT	endoderm_postMG_lateral
ACCTACCCACAGTCGC	endoderm_postMG_ventral
ACCTACCGTCGCACGT	ectoderm_hindgut_dorsal
ACCTGAATCTGCTGAA	endoderm_postMG_ventral
ACGATCAAGGCACTCC	ectoderm_PS14_dorsal
ACGATCACACAAAGCG	endoderm_postMG_lateral
ACGATCATCGACGCTG	endoderm_postMG_ventral
ACGCACGAGGATAATC	ectoderm_PS14/hindgut
ACGCACGCAGATCCAT	ectoderm_PS14_ventral
ACGCACGCAGCTATAC	endoderm_postMG_ventral
ACGGAAGTCTAGTCAG	ectoderm_hindgut_dorsal
ACGGGTCCACAGACGA	ectoderm_hindgut_ventral
ACGGTTATCACTCGAA	ectoderm_hindgut_ventral
ACGTAACAGAGATTCA	endoderm_postMG_lateral
ACGTACACACAACGTT	endoderm_postMG_lateral
ACGTACATCTCTTGCG	ectoderm_hindgut_ventral
ACGTACATCTTGGGCG	ectoderm_PS14/hindgut
ACGTAGTCATCCGGCA	endoderm_postMG_dorsal
ACTATCTGTATTAAGG	ectoderm_hindgut_ventral
ACTATTCTCATCTGTT	ectoderm_PS14_dorsal
ACTGATGCAGACTCTA	ectoderm_PS14_ventral
ACTGATGTCGGCCTTT	ectoderm_PS14_dorsal
ACTGTCCAGGCCACTC	ectoderm_PS14/hindgut
ACTGTCCTCTCATGGA	ectoderm_hindgut_ventral
ACTGTGAAGAGTCTTC	ectoderm_PS14_ventral
ACTTAGGCATCGCTCT	endoderm_postMG_lateral
ACTTATCGTCCAGCAC	endoderm_postMG_ventral
ACTTCCGAGGTAACTA	endoderm_postMG_dorsal
ACTTCGCTCGGTTAGT	endoderm_postMG_lateral
ACTTTGTCACGTCGTG	endoderm_postMG_dorsal
ACTTTGTGTTCCGCTT	ectoderm_PS14_dorsal
AGAAATGAGTGCACCC	ectoderm_PS14_dorsal
AGAAATGCAGAGCCCT	ectoderm_PS14/hindgut
AGAAATGGTCCGGTCA	ectoderm_hindgut_dorsal
AGAACCTCATGAAGCG	ectoderm_PS14/hindgut
AGAAGTAGTCTGTTAG	ectoderm_PS14/hindgut
AGACACTGTAGACGGT	ectoderm_PS14_ventral
AGACCATAGAATAGTC	ectoderm_hindgut_dorsal
AGACCATCAGTGTGCC	ectoderm_PS14_dorsal
AGAGAATGTACTGCGC	ectoderm_hindgut_dorsal
AGAGAGCTCCAATCCC	ectoderm_PS14/hindgut
AGAGAGCTCTGACCCT	endoderm_postMG_lateral
AGAGCAGAGCTGTGCC	ectoderm_PS14/hindgut
AGAGCCCGTCCATAGT	ectoderm_hindgut_ventral
AGATAGACACAAAGTA	endoderm_postMG_dorsal
AGATAGAGTAAGCAAT	ectoderm_hindgut_ventral
AGATCCATCAGAGCGA	ectoderm_PS14_ventral
AGATCGTTCTCGCTCA	endoderm_postMG_dorsal
AGATGAACACGAGAAC	ectoderm_PS14_dorsal
AGATGAAGTTGGTGTT	endoderm_postMG_lateral
AGCATCACATACCATG	endoderm_postMG_lateral
AGCCAGCTCCACAAGT	endoderm_postMG_dorsal
AGCGATTTCGTCCTCA	endoderm_postMG_lateral
AGCGCTGGTGAATGAT	ectoderm_hindgut_ventral
AGCTACATCTACCACC	ectoderm_hindgut_ventral
AGCTCAAAGTAGGTTA	ectoderm_PS14_dorsal
AGCTCAACACCCAAGC	ectoderm_hindgut_ventral
AGCTCAAGTATGCGTT	endoderm_postMG_dorsal
AGGAAATCACGGAAGT	ectoderm_hindgut_ventral
AGGAAATCAGCTTTGA	endoderm_postMG_dorsal
AGGAAATTCCATACTT	endoderm_postMG_ventral
AGGACGATCTCATTTG	ectoderm_PS14_dorsal
AGGATAAAGGAGATAG	ectoderm_hindgut_dorsal
AGGATAAGTTGTGGAG	endoderm_postMG_lateral
AGGATCTAGCGCCGTT	ectoderm_PS14_dorsal
AGGATCTGTGGTCTGC	endoderm_postMG_dorsal
AGGCATTTCGAGAAAT	ectoderm_PS14_dorsal
AGGGCCTAGAGCCTGA	ectoderm_PS14_ventral
AGGGTCCGTGTCTCCT	endoderm_postMG_lateral
AGGGTGATCCCAAGTA	endoderm_postMG_lateral
AGGGTGATCCGTACGG	ectoderm_hindgut_ventral
AGGTAGGGTGCTAGCC	endoderm_postMG_lateral
AGGTAGGTCCTTGAAG	endoderm_postMG_lateral
AGGTCATAGATCCAAA	ectoderm_hindgut_ventral
AGGTCATCAAGAATGT	amnioserosa_PS14
AGGTGTTTCATGCGGC	endoderm_postMG_dorsal
AGGTTGTCATGACAAA	endoderm_postMG_ventral
AGGTTGTGTATGAGAT	ectoderm_hindgut_ventral
AGTAGCTAGACCATTC	endoderm_postMG_lateral
AGTAGCTGTACGAGTG	endoderm_postMG_ventral
AGTAGTCTCACGTCCT	endoderm_postMG_ventral
AGTCAACAGATTCGCT	endoderm_postMG_ventral
AGTCACAGTACCGTGC	endoderm_postMG_ventral
AGTCATGCATTCTCTA	endoderm_postMG_dorsal
AGTGACTAGATCGACG	endoderm_postMG_dorsal
AGTGCCGAGAGCTTTC	ectoderm_PS14_ventral
AGTGCCGGTCTGGTTA	endoderm_postMG_lateral
AGTGTTGAGATGCTTC	endoderm_postMG_dorsal
AGTTCCCCATCGAAGG	ectoderm_PS14_dorsal
AGTTCGAGTGGGTATG	endoderm_postMG_lateral
ATACCGATCTACTCAT	ectoderm_hindgut_ventral
ATACCTTCAGCTTCGG	endoderm_postMG_lateral
ATACTTCAGCAGGTCA	endoderm_postMG_ventral
ATACTTCGTCAAAGAT	endoderm_postMG_dorsal
ATAGGCTAGGTTACAA	ectoderm_PS14/hindgut
ATCACAGCACAGCATT	ectoderm_PS14_ventral
ATCACGAAGCATTGTC	endoderm_postMG_dorsal
ATCACGATCTTCTAAC	amnioserosa_PS14
ATCAGGTCAACCAGAG	ectoderm_PS14/hindgut
ATCAGGTCAATGCTCA	endoderm_postMG_dorsal
ATCATTCAGAGGGTAA	ectoderm_hindgut_ventral
ATCCATTAGTGGTTGG	endoderm_postMG_dorsal
ATCCCTGGTGCCTTTC	endoderm_postMG_lateral
ATCCTATAGTGAGGCT	endoderm_postMG_lateral
ATCCTATTCGATTGAC	endoderm_postMG_lateral
ATCGGATTCAGTGCGC	ectoderm_PS14_dorsal
ATCGGCGCATTAGGAA	ectoderm_hindgut_dorsal
ATCGTAGAGCTGTCCG	endoderm_postMG_lateral
ATCGTAGAGGTACAAT	ectoderm_PS14_dorsal
ATCGTCCGTAGACGTG	endoderm_postMG_lateral
ATCTTCAGTGCCTAAT	endoderm_postMG_lateral
ATCTTCAGTGTTTACG	ectoderm_PS14/hindgut
ATGAAAGAGGGCTAAC	endoderm_postMG_lateral
ATGACCAAGTGTTGAA	endoderm_postMG_lateral
ATGAGGGAGCTGGCCT	ectoderm_PS14_dorsal
ATGATCGAGGAACGAA	endoderm_postMG_lateral
ATGCCTCAGTACGTCT	ectoderm_hindgut_dorsal
ATGCGATAGCCAACCC	ectoderm_PS14_dorsal
ATGCGATAGTGGAATT	ectoderm_hindgut_dorsal
ATGCGATCAGTGTGGA	ectoderm_hindgut_ventral
ATGCGATTCACATTGG	ectoderm_PS14_dorsal
ATGGAGGAGGTAGTCG	endoderm_postMG_lateral
ATGGATCAGGAACGTC	endoderm_postMG_dorsal
ATGGATCAGTCCCGAC	endoderm_postMG_dorsal
ATGGATCAGTGAATAC	ectoderm_hindgut_ventral
ATGGGAGGTATGCTTG	ectoderm_PS14_dorsal
ATGTCCCTCAGCTTCC	endoderm_postMG_ventral
ATTACTCCATAGGCGA	endoderm_postMG_lateral
ATTATCCGTACAGCGA	endoderm_postMG_lateral
ATTCCCGCATCCGAGC	ectoderm_hindgut_ventral
ATTCGTTGTCGTCAGC	ectoderm_hindgut_dorsal
ATTCTACAGCCTTCTC	endoderm_postMG_lateral
ATTCTTGGTACTGACT	endoderm_postMG_lateral
ATTCTTGTCCATACAG	endoderm_postMG_dorsal
ATTGTTCTCAGGCGAA	ectoderm_hindgut_ventral
ATTTACCTCCATTCAT	endoderm_postMG_ventral
ATTTACCTCTTAGCAG	endoderm_postMG_lateral
ATTTCACCAGGCTTGC	endoderm_postMG_lateral
ATTTCTGAGATCCAAA	endoderm_postMG_lateral
ATTTCTGGTTCTTCAT	ectoderm_hindgut_dorsal
CAAAGAATCTGGAAGG	endoderm_postMG_ventral
CAACAGTGTCACCACG	ectoderm_PS14_ventral
CAACAGTTCTAGGAAA	ectoderm_PS14_dorsal
CAACCTCGTAACCCTA	ectoderm_hindgut_ventral
CAACCTCTCGACGTCG	ectoderm_hindgut_dorsal
CAACGATGTGAGACGT	endoderm_postMG_dorsal
CAACGGCAGGATCACG	ectoderm_PS14_dorsal
CAACGGCCAGCTTCCT	ectoderm_PS14_dorsal
CAAGACTAGGCTTAGG	ectoderm_PS14_dorsal
CAAGACTCACAACGTT	ectoderm_hindgut_ventral
CAAGCTACATTCACAG	ectoderm_PS14_dorsal
CAAGGGACAGTCAGCC	ectoderm_PS14_dorsal
CAATCGAAGTGGACGT	endoderm_postMG_ventral
CAATCGATCCGTAATG	ectoderm_PS14_dorsal
CAATGACCACAAAGTA	ectoderm_PS14/hindgut
CACAACAGTCTGGTTA	ectoderm_hindgut_dorsal
CACAACATCAGCAATC	endoderm_postMG_ventral
CACACAACATCTATCT	endoderm_postMG_lateral
CACACAATCACAAGAA	endoderm_postMG_lateral
CACAGATAGCATTTCG	ectoderm_PS14_ventral
CACAGATCAGCCCACA	endoderm_postMG_dorsal
CACAGATGTGCCCAGT	endoderm_postMG_lateral
CACAGATTCCTATTTG	ectoderm_PS14_ventral
CACATGAAGCTAAACA	endoderm_postMG_lateral
CACATGAGTGTCCGGT	ectoderm_hindgut_ventral
CACCAAACACAGCTTA	ectoderm_PS14/hindgut
CACCGTTTCACGAACT	ectoderm_hindgut_ventral
CACGAATTCGACGAGA	ectoderm_hindgut_dorsal
CACGGGTTCATGTCAG	endoderm_postMG_lateral
CACGTGGAGACCTCAT	ectoderm_PS14_dorsal
CACGTGGCACTTGAGT	ectoderm_PS14/hindgut
CACGTGGCAGAACGCA	endoderm_postMG_lateral
CACGTGGGTAGAATGT	ectoderm_PS14_dorsal
CACGTTCGTCAAAGCG	ectoderm_PS14/hindgut
CACTAAGAGTGGATAT	ectoderm_PS14_ventral
CACTGGGAGGTCGTAG	ectoderm_hindgut_dorsal
CACTGTCGTCCCTAAA	ectoderm_PS14/hindgut
CAGATACAGTCACAGG	endoderm_postMG_ventral
CAGATTGAGACGACTG	ectoderm_hindgut_dorsal
CAGATTGCATGTCGTA	ectoderm_hindgut_dorsal
CAGATTGGTCACTCTC	ectoderm_hindgut_dorsal
CAGCAATAGGCTCTAT	ectoderm_PS14_dorsal
CAGCAATTCAACTACG	ectoderm_PS14_ventral
CAGGCCACAAGCGAAC	ectoderm_hindgut_ventral
CAGGGCTAGCAAGGAA	endoderm_postMG_dorsal
CAGTTAGTCCTCACCA	endoderm_postMG_ventral
CATAAGCGTGAGATAT	endoderm_postMG_ventral
CATACAGAGATAGTCA	endoderm_postMG_lateral
CATACCCAGAGTATAC	endoderm_postMG_ventral
CATACCCCAGAGACTG	endoderm_postMG_lateral
CATACCCTCACTCGAA	endoderm_postMG_lateral
CATACTTAGGAGTATT	ectoderm_hindgut_ventral
CATCAAGCAAGGTCGA	endoderm_postMG_lateral
CATCAAGTCAGTGGGA	ectoderm_PS14/hindgut
CATCCACAGTTCAACC	ectoderm_PS14/hindgut
CATCCACCAGGTGTGA	endoderm_postMG_ventral
CATCCACTCGCTTAAG	endoderm_postMG_lateral
CATCCCAGTTCCTAGA	endoderm_postMG_dorsal
CATCCGTAGGGTGAAA	endoderm_postMG_dorsal
CATCCGTAGGTAAGAG	ectoderm_hindgut_dorsal
CATCGGGCACAATGAA	amnioserosa_PS14
CATCGGGGTTGCCAAT	ectoderm_PS14/hindgut
CATGCCTGTCTACAGT	endoderm_postMG_ventral
CATGCCTGTGTAGCAG	ectoderm_PS14/hindgut
CATGCTCAGGTGCGAT	endoderm_postMG_dorsal
CATGCTCCACGGGTAA	ectoderm_PS14_dorsal
CATGGATAGACATATG	ectoderm_PS14_dorsal
CATGGATTCGTTACCC	ectoderm_hindgut_dorsal
CATGGTAAGTAGAATC	ectoderm_PS14_dorsal
CATGGTATCCTACTGC	ectoderm_PS14_dorsal
CATTCATCATGCCGAC	endoderm_postMG_dorsal
CATTCATGTACAATAG	endoderm_postMG_ventral
CATTCATTCTAACGCA	ectoderm_hindgut_dorsal
CATTCTAGTAATCAGA	endoderm_postMG_lateral
CATTGAGAGTAGACAT	endoderm_postMG_lateral
CATTGAGTCTGAGAAA	ectoderm_PS14/hindgut
CATTGTTAGCAGCGAT	ectoderm_hindgut_ventral
CATTTCAAGCACCGTC	ectoderm_PS14/hindgut
CCAATTTCAGACCATT	endoderm_postMG_ventral
CCAATTTGTTCGGCTG	ectoderm_PS14_dorsal
CCAATTTTCCTCACCA	endoderm_postMG_dorsal
CCACAAAAGGTAGCCA	endoderm_postMG_ventral
CCACAAACAGCATGCC	endoderm_postMG_ventral
CCACAAAGTACTCGCG	ectoderm_hindgut_dorsal
CCACAAAGTGGACTAG	amnioserosa_PS14
CCACAAATCATGCCCT	endoderm_postMG_dorsal
CCACACTAGGTAGCAC	endoderm_postMG_ventral
CCACCATGTATCGCGC	endoderm_postMG_ventral
CCACGAGAGCCGAACA	endoderm_postMG_dorsal
CCACGTTTCCCGTTCA	endoderm_postMG_ventral
CCATAAGGTCCGCAGT	ectoderm_PS14_ventral
CCATCACAGAGTGAAG	endoderm_postMG_ventral
CCCAACTAGGTAGACC	ectoderm_PS14_ventral
CCCAACTAGTCATAGA	endoderm_postMG_dorsal
CCCGAAGCAGACAATA	endoderm_postMG_ventral
CCCGAAGCAGACGCTC	ectoderm_hindgut_ventral
CCCGAAGTCGTCACCT	ectoderm_PS14_dorsal
CCCGGAACACAGGATG	ectoderm_hindgut_ventral
CCCTAACAGTACTCGT	endoderm_postMG_lateral
CCCTAACGTACAACGG	endoderm_postMG_dorsal
CCCTAACGTGGCGTAA	endoderm_postMG_lateral
CCCTCAAAGCCGATAG	ectoderm_PS14_dorsal
CCCTCTCCAGCCTTCT	endoderm_postMG_dorsal
CCCTCTCGTAGCTTGT	ectoderm_PS14/hindgut
CCCTCTCTCTGAATGC	ectoderm_PS14/hindgut
CCCTGATGTAGGTTTC	ectoderm_PS14_dorsal
CCCTGATTCTTCTCAA	endoderm_postMG_lateral
CCGATCTAGGCCTAGA	endoderm_postMG_lateral
CCGCAAGGTTTCGGCG	endoderm_postMG_ventral
CCGCAAGTCGGTGTAT	endoderm_postMG_dorsal
CCGGACACACATGACT	ectoderm_PS14/hindgut
CCGGACACATTGTAGC	ectoderm_PS14/hindgut
CCGGTAGAGCAAACAT	ectoderm_PS14/hindgut
CCGGTGAGTGAGGCAT	endoderm_postMG_ventral
CCGTGAGAGGGCAAGG	ectoderm_PS14/hindgut
CCGTTCAAGCTCACTA	ectoderm_PS14_dorsal
CCGTTCACAGATTAAG	ectoderm_hindgut_dorsal
CCTATCGCAGGAATAT	endoderm_postMG_dorsal
CCTATCGGTCGTAATC	ectoderm_PS14/hindgut
CCTATCGTCACTGATG	endoderm_postMG_ventral
CCTCCAACATCTAGAC	endoderm_postMG_dorsal
CCTCCTCAGAAGTGTT	endoderm_postMG_dorsal
CCTCCTCCAGTCGCAC	endoderm_postMG_dorsal
CCTCCTCGTCGTTGGC	endoderm_postMG_dorsal
CCTCTAGAGGTTCTAC	endoderm_postMG_dorsal
CCTCTCCTCACTGTCC	endoderm_postMG_dorsal
CCTGTTGGTATCATGC	ectoderm_PS14/hindgut
CCTTCAGTCCACTTTA	ectoderm_PS14_dorsal
CCTTCAGTCCGTGTGG	ectoderm_hindgut_dorsal
CCTTGTGTCAGCTTGA	endoderm_postMG_dorsal
CCTTTGGTCTCGGTAA	ectoderm_hindgut_ventral
CGAAGGACACATTCTT	endoderm_postMG_dorsal
CGAATTGGTGGTTTAC	endoderm_postMG_ventral
CGAGAAGCATATCTGG	ectoderm_hindgut_ventral
CGAGAAGGTCTGATCA	ectoderm_PS14_ventral
CGAGGAATCTCATGGA	endoderm_postMG_lateral
CGAGGCTAGACTGGGT	endoderm_postMG_lateral
CGAGGCTGTGGAAATT	endoderm_postMG_ventral
CGAGTTATCGCACTCT	endoderm_postMG_lateral
CGATCGGCAGTAGAGC	endoderm_postMG_lateral
CGCAGGTGTTCTCGCT	endoderm_postMG_lateral
CGCATAAAGCGTTCCG	ectoderm_PS14_dorsal
CGCATGGCAATTCTTC	endoderm_postMG_dorsal
CGGAACCAGGTTACAA	ectoderm_hindgut_ventral
CGGAATTCACAACGCC	ectoderm_PS14_ventral
CGGAATTGTACTGACT	ectoderm_hindgut_dorsal
CGGGACTTCACCACAA	ectoderm_hindgut_ventral
CGGGACTTCGATAACC	endoderm_postMG_dorsal
CGGGTGTGTCTGCCTT	ectoderm_PS14_dorsal
CGTAAGTTCCAAACCA	ectoderm_hindgut_ventral
CGTAATGTCTCGCGTT	endoderm_postMG_dorsal
CGTAATGTCTTAGGAC	ectoderm_PS14/hindgut
CGTAGTACAACAGCCC	ectoderm_PS14_dorsal
CGTCAAATCACCTCTG	endoderm_postMG_dorsal
CGTCCATAGGTCGAGT	ectoderm_PS14_dorsal
CGTGAATAGATGACCG	endoderm_postMG_dorsal
CGTGAATAGTATAGGT	ectoderm_PS14_dorsal
CGTGATAAGCATTTGC	endoderm_postMG_ventral
CGTGATAAGGTGCTAG	ectoderm_hindgut_dorsal
CGTGATACAACACGAG	ectoderm_hindgut_ventral
CGTGATAGTACGGCAA	endoderm_postMG_lateral
CGTGATATCCGTGACG	endoderm_postMG_lateral
CGTGCTTGTAGATCCT	endoderm_postMG_lateral
CGTGCTTGTCACCGCA	ectoderm_PS14_ventral
CGTGCTTTCATCCCGT	endoderm_postMG_dorsal
CGTGTCTCAGGCATGA	endoderm_postMG_lateral
CGTTAGACATCTCATT	endoderm_postMG_lateral
CGTTAGAGTAACAAGT	endoderm_postMG_lateral
CGTTAGAGTATACGGG	endoderm_postMG_dorsal
CGTTCTGTCAATCAGC	endoderm_postMG_lateral
CGTTGGGCATTCATCT	endoderm_postMG_dorsal
CTAACTTCAGAGTTGG	ectoderm_hindgut_dorsal
CTAACTTTCGTGGAAG	ectoderm_PS14/hindgut
CTAAGTGCAAACAGGC	endoderm_postMG_dorsal
CTACCTGAGGTTCCGC	ectoderm_hindgut_dorsal
CTACCTGGTCAAAGAT	endoderm_postMG_dorsal
CTACCTGGTCCGACGT	amnioserosa_PS14
CTACGGGAGTCTCCTC	ectoderm_hindgut_ventral
CTACTATTCATCCCGT	endoderm_postMG_lateral
CTAGACAGTGGATCGA	ectoderm_hindgut_ventral
CTAGGTAAGTTACGGG	endoderm_postMG_lateral
CTAGGTAAGTTACGTC	endoderm_postMG_ventral
CTATCCGAGACGTCCC	ectoderm_hindgut_ventral
CTATCCGGTCACTCAA	endoderm_postMG_ventral
CTCAAGAAGTCTAGCT	ectoderm_PS14_dorsal
CTCAATTAGAAGGATG	ectoderm_hindgut_dorsal
CTCAATTAGTTTAGGA	ectoderm_PS14/hindgut
CTCAATTAGTTTCGGT	endoderm_postMG_dorsal
CTCACTGCAGCTAACT	endoderm_postMG_dorsal
CTCACTGGTAGACTGG	ectoderm_PS14/hindgut
CTCAGAAGTGATACCT	ectoderm_hindgut_dorsal
CTCAGGGAGGTTGAGC	ectoderm_PS14_dorsal
CTCATCGTCCGATGTA	endoderm_postMG_dorsal
CTCATGCTCCGAGATT	ectoderm_PS14_dorsal
CTCCACACAGAGGCAT	endoderm_postMG_lateral
CTCCATGGTGAGGAAA	endoderm_postMG_lateral
CTCCCAACACATTGTG	endoderm_postMG_lateral
CTCCGATTCGGTTCAA	endoderm_postMG_lateral
CTCCTCCAGTTTGCTG	ectoderm_hindgut_dorsal
CTCCTCCTCCGAACGC	endoderm_postMG_ventral
CTCCTTTCAAGTCCAT	endoderm_postMG_dorsal
CTCCTTTGTACCCAGC	endoderm_postMG_lateral
CTCGAGGGTTGCAACT	ectoderm_hindgut_dorsal
CTCTCGACACGAGGAT	endoderm_postMG_dorsal
CTCTCGACATCGAACT	ectoderm_PS14_dorsal
CTGAGCGAGCATATGA	endoderm_postMG_ventral
CTGAGGCAGAAACCCG	ectoderm_PS14/hindgut
CTGAGGCTCTTTCTAG	endoderm_postMG_ventral
CTGATCCAGCTTGTTG	endoderm_postMG_dorsal
CTGATCCCATTGTAGC	endoderm_postMG_dorsal
CTGATCCTCGTGGGAA	endoderm_postMG_lateral
CTGCATCGTGTCGCTG	ectoderm_PS14_dorsal
CTGCGAGTCACCATGA	ectoderm_PS14/hindgut
CTGCTCAGTGGAATGC	ectoderm_PS14_dorsal
CTGGCAGAGAAGGGAT	endoderm_postMG_lateral
CTGGTCTGTTACGGAG	endoderm_postMG_ventral
CTGTATTGTTTACTGG	endoderm_postMG_dorsal
CTGTATTTCCATAGGT	ectoderm_PS14_dorsal
CTGTATTTCCGTGACG	ectoderm_hindgut_ventral
CTGTCGTAGCGTATAA	ectoderm_PS14/hindgut
CTGTGAAAGGGAGTGG	ectoderm_PS14_dorsal
CTTACCGAGCCTGACC	ectoderm_hindgut_dorsal
CTTACCGAGCGTCTCG	endoderm_postMG_dorsal
CTTACCGTCCCTGTTG	endoderm_postMG_dorsal
CTTCAATCATTCTTCA	ectoderm_hindgut_dorsal
CTTCCGAAGCTATCTG	endoderm_postMG_ventral
CTTCCGAAGTATGGCG	endoderm_postMG_lateral
CTTCCGAGTTCCGCAG	ectoderm_hindgut_dorsal
CTTCTAATCCATTCAT	ectoderm_PS14/hindgut
CTTCTCTGTCTGCATA	ectoderm_hindgut_dorsal
CTTCTCTGTCTTGAGT	endoderm_postMG_dorsal
CTTTCAAAGTCTGCAT	endoderm_postMG_lateral
CTTTCGGCAAACCACT	ectoderm_PS14_dorsal
GAAACCTAGATTAGTG	endoderm_postMG_lateral
GAAACCTGTGGACCAA	endoderm_postMG_lateral
GAAATGAAGACTCCGC	ectoderm_PS14/hindgut
GAAATGAGTATCCTCC	endoderm_postMG_lateral
GAAATGAGTCAATCTG	ectoderm_PS14_dorsal
GAAATGATCCCTCTTT	endoderm_postMG_dorsal
GAACGTTTCCTCAGAA	endoderm_postMG_lateral
GAACTGTGTTCGTTCC	endoderm_postMG_lateral
GAAGAATAGTGCGCTC	endoderm_postMG_lateral
GAAGAATGTCTTGGTA	endoderm_postMG_dorsal
GAAGCCCAGCGTGTTT	endoderm_postMG_lateral
GAATAGAAGCTAAACA	endoderm_postMG_lateral
GAATAGACATTAGGCT	endoderm_postMG_ventral
GAATCGTCATCCAACA	ectoderm_hindgut_ventral
GAATCGTGTTCTGACA	endoderm_postMG_ventral
GACATCAAGTGTACAA	ectoderm_hindgut_dorsal
GACATCAGTAGTCACT	endoderm_postMG_dorsal
GACCAATTCTAGTTCT	ectoderm_hindgut_dorsal
GACCCAGCACGTTCGG	endoderm_postMG_lateral
GACCCAGCACTCTGCT	ectoderm_PS14_dorsal
GACCCTTGTATCGTGT	ectoderm_hindgut_ventral
GACCCTTGTCCTGGGT	ectoderm_PS14/hindgut
GACCCTTGTGATATAG	ectoderm_hindgut_ventral
GACGCTGTCAGACATC	endoderm_postMG_ventral
GACGTTACAAGATTGA	endoderm_postMG_dorsal
GACGTTAGTATTCCTT	endoderm_postMG_dorsal
GACGTTATCAGGGATG	endoderm_postMG_lateral
GACTATGCACCTCTGT	endoderm_postMG_ventral
GACTATGCATGGAGAC	endoderm_postMG_lateral
GACTATGTCGGTGCAC	endoderm_postMG_lateral
GACTCTCGTAAGCGGT	ectoderm_PS14/hindgut
GACTGATCAGAAGTTA	endoderm_postMG_lateral
GACTGATGTTTCGTTT	ectoderm_hindgut_dorsal
GACTTCCAGCAGTACG	endoderm_postMG_dorsal
GACTTCCGTCGACTTA	ectoderm_hindgut_dorsal
GAGAAATGTCTTCCGT	endoderm_postMG_ventral
GAGAAATTCCGAAATC	endoderm_postMG_lateral
GAGACCCGTCTGTCAA	endoderm_postMG_ventral
GAGAGGTAGCAAACAT	endoderm_postMG_dorsal
GAGAGGTAGGACCCAA	ectoderm_hindgut_ventral
GAGATGGTCGGCGATC	ectoderm_PS14_dorsal
GAGGCCTGTTATCTGG	endoderm_postMG_lateral
GAGGGTATCCTTCAGC	endoderm_postMG_dorsal
GAGTCATTCTGCGGAC	endoderm_postMG_lateral
GAGTCTACAGTTAAAG	ectoderm_hindgut_dorsal
GAGTCTAGTTCGGACC	endoderm_postMG_lateral
GAGTGAGAGTACAGCG	endoderm_postMG_ventral
GAGTGAGGTAGGTACG	ectoderm_hindgut_ventral
GAGTGTTCAGACAATA	endoderm_postMG_dorsal
GAGTGTTTCTTCGCTG	endoderm_postMG_ventral
GAGTTACCAGCGTATT	endoderm_postMG_dorsal
GAGTTTGAGGCTAGCA	ectoderm_hindgut_ventral
GATAGAAAGTCACTCA	ectoderm_PS14_ventral
GATCACACAACTGTGT	endoderm_postMG_lateral
GATCAGTTCCGCTAGG	endoderm_postMG_lateral
GATCATGAGCTCACTA	ectoderm_PS14_ventral
GATCATGGTGGTAATA	ectoderm_PS14_dorsal
GATCATGGTTGAGTCT	endoderm_postMG_dorsal
GATGACTTCTCAGTCC	endoderm_postMG_lateral
GATGAGGTCAATCGGT	endoderm_postMG_ventral
GATGATCGTGTCCAAT	endoderm_postMG_dorsal
GATGCTATCAAGAGGC	ectoderm_PS14_ventral
GATTCGAGTTACGATC	ectoderm_PS14_ventral
GCAACATTCGGACGTC	ectoderm_PS14_ventral
GCACGTGTCAACACCA	ectoderm_hindgut_ventral
GCACTAAAGTACGAGC	ectoderm_PS14/hindgut
GCACTAACAATTGGTC	ectoderm_PS14_ventral
GCACTAATCCGCGGAT	ectoderm_hindgut_ventral
GCAGCCACACTATCGA	amnioserosa_PS14
GCAGGCTAGTATAGGT	ectoderm_hindgut_ventral
GCAGTTACAGTTCACA	endoderm_postMG_dorsal
GCAGTTATCCGAAATC	endoderm_postMG_ventral
GCATGATAGAATTGTG	endoderm_postMG_dorsal
GCATGATCAGGTTCAT	endoderm_postMG_lateral
GCCAGGTGTTGCGTAT	endoderm_postMG_dorsal
GCCATTCCATATCTCT	ectoderm_hindgut_ventral
GCCCAGATCTTTGGAG	ectoderm_PS14/hindgut
GCCCGAATCTTGAACG	ectoderm_hindgut_ventral
GCCGATGCAGGTCTCG	endoderm_postMG_ventral
GCGAGAACAAACACGG	ectoderm_hindgut_ventral
GCGTGCACATACAGGG	endoderm_postMG_ventral
GCGTGCAGTCCCGTGA	ectoderm_PS14_dorsal
GCGTTTCTCACTGCTC	ectoderm_PS14_dorsal
GCGTTTCTCCTTCTGG	ectoderm_hindgut_dorsal
GCTACCTGTAGGGAGG	endoderm_postMG_lateral
GCTCAAACAAAGGGTC	endoderm_postMG_dorsal
GCTTTCGCATTCTCCG	ectoderm_PS14_ventral
GGAAGTGCACAGCGCT	ectoderm_PS14/hindgut
GGAATCTCAGCAGTAG	ectoderm_PS14/hindgut
GGAATCTGTGGATTTC	endoderm_postMG_ventral
GGAATGGGTCACCACG	ectoderm_PS14_dorsal
GGAATGGTCCATGATG	endoderm_postMG_dorsal
GGAGATGTCTCACGAA	ectoderm_PS14_ventral
GGATCTAAGTCCCAAT	endoderm_postMG_lateral
GGATCTACAGGCCCTA	endoderm_postMG_lateral
GGCACGTCAAGTCATC	endoderm_postMG_lateral
GGCAGTCGTCGAATGG	endoderm_postMG_lateral
GGCGTCAAGTAGGCCA	ectoderm_PS14/hindgut
GGCGTCAGTGCCCACA	ectoderm_hindgut_ventral
GGCGTCATCGTTATCT	endoderm_postMG_ventral
GGCTTGGTCTCAATCT	ectoderm_PS14_dorsal
GGGACAAAGCAGTAAT	endoderm_postMG_lateral
GGGACCTCAGCCTACG	endoderm_postMG_ventral
GGGACTCTCGAACACT	endoderm_postMG_ventral
GGGAGATCAGTTGTTG	endoderm_postMG_lateral
GGGAGTACAAGTCATC	ectoderm_hindgut_dorsal
GGGATGAAGATCCTAC	ectoderm_hindgut_ventral
GGGCTCAAGATACTGA	ectoderm_hindgut_ventral
GGGCTCATCATGCCGG	endoderm_postMG_dorsal
GGGTCACTCGATCCCT	endoderm_postMG_lateral
GGGTCTGAGTTGTCAC	ectoderm_hindgut_dorsal
GGGTGAAAGCAGGCTA	ectoderm_PS14_dorsal
GGGTGAAGTCGTCATA	ectoderm_hindgut_ventral
GGGTGTCAGGGAGGTG	ectoderm_PS14_dorsal
GGGTTTACAAGCTACT	endoderm_postMG_dorsal
GGTAGAGTCTTCGATT	ectoderm_PS14_dorsal
GGTCTGGAGACCAAGC	ectoderm_hindgut_dorsal
GGTGATTAGCACTCGC	endoderm_postMG_dorsal
GGTGATTAGGCCCGTT	endoderm_postMG_dorsal
GGTTAACGTACGTTCA	ectoderm_PS14_dorsal
GGTTAACTCAAGGACG	ectoderm_hindgut_dorsal
GGTTCTCTCATACGGT	ectoderm_PS14/hindgut
GGTTGTAAGTTTGAGA	ectoderm_PS14_ventral
GTAACACCAACTGAAA	endoderm_postMG_dorsal
GTAACACGTTCCGTTC	endoderm_postMG_dorsal
GTAAGTCAGTGGCAGT	ectoderm_PS14_ventral
GTACAACGTTTCGGCG	endoderm_postMG_dorsal
GTACAGTTCGCTCTAC	ectoderm_hindgut_dorsal
GTAGAAAGTAGTCCTA	ectoderm_hindgut_ventral
GTAGAGGAGGCCTAGA	endoderm_postMG_dorsal
GTAGCTACAACTCGAT	endoderm_postMG_lateral
GTAGGAGCACTGATTG	endoderm_postMG_ventral
GTATTGGCAGAGGCAT	endoderm_postMG_ventral
GTATTGGCAGGTACGA	endoderm_postMG_lateral
GTATTGGGTGCTGTCG	ectoderm_PS14/hindgut
GTATTTCCAACATCGT	ectoderm_PS14_dorsal
GTATTTCCACTTGGGC	ectoderm_hindgut_dorsal
GTCAAACAGTAGGCCA	endoderm_postMG_lateral
GTCACGGTCCCAGGCA	endoderm_postMG_lateral
GTCACTCTCCGTAATG	ectoderm_hindgut_dorsal
GTCAGCGGTCTTTATC	ectoderm_hindgut_ventral
GTCAGCGTCTTACGTT	endoderm_postMG_lateral
GTCATCCGTCAGACGA	endoderm_postMG_lateral
GTCATGAAGACCCGCT	endoderm_postMG_ventral
GTCATGACAACCCTAA	endoderm_postMG_ventral
GTCCACTCATGTACGT	endoderm_postMG_dorsal
GTCCACTTCGATGCTA	ectoderm_PS14/hindgut
GTCCCATTCCTCACCA	endoderm_postMG_lateral
GTCCTCAGTTTCTATC	endoderm_postMG_lateral
GTCGAATCACTGAGTT	ectoderm_hindgut_ventral
GTCGAATGTTGCTCCT	endoderm_postMG_ventral
GTCGCGATCCAGCAAT	endoderm_postMG_lateral
GTCGTAAAGGGATGTC	ectoderm_hindgut_ventral
GTCGTTCTCACGGGCT	ectoderm_PS14_ventral
GTCTACCCAAACACCT	ectoderm_hindgut_ventral
GTCTACCGTATTCTCT	endoderm_postMG_ventral
GTCTACCGTGCTCTCT	ectoderm_hindgut_ventral
GTCTAGACATTGAGGG	endoderm_postMG_dorsal
GTCTCACTCTTACCAT	endoderm_postMG_ventral
GTCTTTACACAGTGAG	ectoderm_PS14/hindgut
GTGAGCCAGTGATAGT	endoderm_postMG_lateral
GTGAGGAAGAGAGCCT	ectoderm_hindgut_dorsal
GTGAGGACATCCAACA	ectoderm_PS14_ventral
GTGAGTTTCGAGTCCG	ectoderm_PS14/hindgut
GTGAGTTTCTTCTTCC	endoderm_postMG_lateral
GTGATGTAGGCATGCA	endoderm_postMG_ventral
GTGATGTCACTAGTAC	ectoderm_PS14_ventral
GTGATGTGTCTTGAAC	ectoderm_hindgut_dorsal
GTGATGTTCCTGTAGA	ectoderm_hindgut_ventral
GTGCACGGTGCCCGTA	ectoderm_hindgut_ventral
GTGCACGTCCTCACTG	endoderm_postMG_lateral
GTGCAGCCACAATGCT	amnioserosa_PS14
GTGCGTGCAAGCGCTC	endoderm_postMG_lateral
GTGCTTCCAGCAGTGA	endoderm_postMG_ventral
GTGCTTCGTTCCTAAG	endoderm_postMG_lateral
GTGCTTCTCCATCTGC	ectoderm_PS14/hindgut
GTGGAAGCACAGAGAC	endoderm_postMG_lateral
GTGGAAGTCCAAACCA	endoderm_postMG_dorsal
GTGGAGAAGCTTGTTG	endoderm_postMG_lateral
GTGGCGTCACTTCTCG	ectoderm_PS14_dorsal
GTGGCGTTCGTTAGAC	ectoderm_hindgut_dorsal
GTGGTTAGTTGGATCT	endoderm_postMG_ventral
GTGTCCTAGACATCAA	ectoderm_PS14_ventral
GTGTCCTGTTGCCGCA	endoderm_postMG_lateral
GTGTCCTTCCACAGGC	ectoderm_hindgut_ventral
GTGTGATGTCCAGCGT	ectoderm_hindgut_ventral
GTGTGGCCAAACTGCT	ectoderm_PS14_dorsal
GTGTTAGAGGGTATAT	ectoderm_PS14/hindgut
GTGTTCCAGCGTCTCG	ectoderm_PS14/hindgut
GTGTTCCCAATCGTCA	ectoderm_PS14_dorsal
GTTACAGCAAATCAAG	ectoderm_PS14_ventral
GTTACCCCATGACCCG	endoderm_postMG_lateral
GTTAGACCAAGTACCT	ectoderm_PS14/hindgut
GTTCATTCAAACGTGG	ectoderm_hindgut_dorsal
GTTCATTCAACACAGG	endoderm_postMG_lateral
GTTCTATTCCAGCACG	ectoderm_PS14/hindgut
GTTGCGGCAGCATCTA	endoderm_postMG_lateral
GTTGTAGCAACGTAAA	ectoderm_hindgut_ventral
GTTGTAGTCCATAGAC	endoderm_postMG_lateral
GTTGTCCGTTAGAAGT	ectoderm_PS14_ventral
GTTGTGAGTACTCGCG	ectoderm_PS14/hindgut
GTTTGGAAGCTACTAC	amnioserosa_PS14
GTTTGGATCTCCAAGA	ectoderm_PS14_dorsal
TAAGCACCAGGTTACT	ectoderm_hindgut_dorsal
TAAGCCACAGGCATGA	ectoderm_hindgut_ventral
TAAGCCATCGCCTTTG	endoderm_postMG_dorsal
TAAGCGTGTGCGGTAA	ectoderm_PS14_ventral
TAAGTCGGTCATAGTC	endoderm_postMG_dorsal
TAAGTCGGTTAACCTG	endoderm_postMG_dorsal
TACAACGCAGTTCTAG	ectoderm_PS14/hindgut
TACAACGTCAACCGAT	ectoderm_PS14_ventral
TACACCCAGGTAAACT	endoderm_postMG_dorsal
TACACCCCATGCTGCG	ectoderm_PS14/hindgut
TACACCCTCACGGGCT	ectoderm_PS14_ventral
TACACCCTCGAGCCAC	ectoderm_PS14_dorsal
TACATTCAGCCGTTAT	ectoderm_PS14/hindgut
TACATTCAGTTGCATC	endoderm_postMG_ventral
TACATTCGTAGTCTGT	ectoderm_PS14/hindgut
TACCCACTCACCATAG	endoderm_postMG_ventral
TACCCACTCGGTCAGC	endoderm_postMG_lateral
TACCCGTGTGCAATAA	endoderm_postMG_lateral
TACCGGGCACGCGTCA	endoderm_postMG_dorsal
TACCGGGTCCGATAGT	endoderm_postMG_lateral
TACCTCGAGCTCGCAC	endoderm_postMG_lateral
TACCTCGCAGGAGACT	ectoderm_hindgut_dorsal
TACCTCGGTATGAGCG	ectoderm_PS14/hindgut
TACCTCGTCACCGGGT	ectoderm_PS14_dorsal
TACCTGCCAATAACCC	ectoderm_PS14/hindgut
TACGCTCGTCAGCTTA	endoderm_postMG_lateral
TACGCTCGTGTTAGCT	ectoderm_PS14_ventral
TACGGGCAGCACACAG	ectoderm_PS14/hindgut
TACGGGCCACAGTGTT	ectoderm_PS14/hindgut
TACGGGCGTCTGATCA	ectoderm_PS14_dorsal
TACGGTAGTATCTTCT	ectoderm_hindgut_dorsal
TACGGTATCCGTTGGG	ectoderm_PS14_ventral
TACTTACCAATTGAAG	ectoderm_hindgut_dorsal
TACTTACCATCGTCCT	ectoderm_hindgut_ventral
TACTTCAGTATTGAGA	ectoderm_hindgut_ventral
TACTTGTTCAGTAGGG	ectoderm_hindgut_ventral
TAGACTGCAGGTCCCA	ectoderm_hindgut_ventral
TAGACTGGTGCATCTA	endoderm_postMG_dorsal
TAGAGTCAGACCATTC	endoderm_postMG_ventral
TAGAGTCAGGCCTGCT	ectoderm_hindgut_ventral
TAGATCGCATTCATCT	endoderm_postMG_lateral
TAGGAGGAGCGACATG	endoderm_postMG_lateral
TAGGGTTAGCCGGATA	endoderm_postMG_lateral
TAGGTACAGAGAGGTA	endoderm_postMG_lateral
TAGGTACTCTAAGCGT	endoderm_postMG_dorsal
TAGTGCAGTCTGCCTT	endoderm_postMG_lateral
TATACCTAGCCAGTAG	amnioserosa_PS14
TATATCCGTACGACTT	ectoderm_PS14_ventral
TATCAGGGTGACAGGT	ectoderm_hindgut_dorsal
TATCAGGGTTAGGCCC	endoderm_postMG_ventral
TATCGCCAGGAACGAA	ectoderm_hindgut_ventral
TATCGCCTCGAGATGG	ectoderm_PS14_ventral
TATCGCCTCTCAATCT	ectoderm_hindgut_ventral
TATCTGTCATCCTGTC	endoderm_postMG_lateral
TATTGCTAGCTGAGTG	endoderm_postMG_ventral
TATTTCGAGAGTTGCG	ectoderm_hindgut_dorsal
TATTTCGAGGCTCTCG	ectoderm_PS14_dorsal
TATTTCGTCGCTCCTA	endoderm_postMG_ventral
TCAAGTGGTAGATCGG	endoderm_postMG_lateral
TCAATCTAGGCACGAT	endoderm_postMG_ventral
TCAATTCCAGAAACCG	ectoderm_PS14/hindgut
TCAATTCGTAGCACGA	ectoderm_hindgut_ventral
TCACAAGTCTAGACCA	ectoderm_hindgut_ventral
TCACACCAGACCAGAC	endoderm_postMG_lateral
TCACACCGTATTCCGA	endoderm_postMG_lateral
TCACTATTCCTCACGT	endoderm_postMG_dorsal
TCAGCCTCAGACCGCT	endoderm_postMG_dorsal
TCAGGTACACTGCGTG	ectoderm_hindgut_ventral
TCAGTCCGTAAGGCCA	endoderm_postMG_dorsal
TCAGTTTTCCGATAGT	ectoderm_hindgut_ventral
TCATACTCATCCGGCA	endoderm_postMG_ventral
TCATACTTCGAACCTA	endoderm_postMG_ventral
TCATCATGTAAGTCAA	endoderm_postMG_dorsal
TCATGAGCATCGAGCC	ectoderm_PS14_ventral
TCATGAGTCTCTGACC	ectoderm_PS14/hindgut
TCATGTTCATCTGCGG	endoderm_postMG_lateral
TCATGTTGTCAACGCC	endoderm_postMG_dorsal
TCCACCAAGCGTCTGC	endoderm_postMG_lateral
TCCACCACATAGATGA	endoderm_postMG_lateral
TCCACGTCAAAGCACG	endoderm_postMG_ventral
TCCACGTCAGAACCGA	endoderm_postMG_lateral
TCCAGAAAGCTGGCCT	endoderm_postMG_ventral
TCCAGAATCCGAAGGA	endoderm_postMG_ventral
TCCCACAGTTCTCCAC	ectoderm_PS14_dorsal
TCCCAGTAGGTCGCCT	ectoderm_hindgut_ventral
TCCCATGAGCATATGA	endoderm_postMG_lateral
TCCGAAACAAAGTGTA	endoderm_postMG_lateral
TCCGAAACAAGGAGTC	endoderm_postMG_lateral
TCCGAAACAGAGTCAG	endoderm_postMG_lateral
TCCGTGTGTAGTCTTG	ectoderm_PS14_ventral
TCCTCCCAGCGCACAA	ectoderm_PS14/hindgut
TCCTCCCCAAATTGCC	ectoderm_hindgut_dorsal
TCCTCCCCATTGCAAC	ectoderm_hindgut_ventral
TCCTCCCTCGAGTCCG	ectoderm_PS14_ventral
TCCTCGAAGTCTGCAT	ectoderm_hindgut_ventral
TCCTGCAGTACTCGAT	endoderm_postMG_dorsal
TCGAACATCATGCCAA	endoderm_postMG_ventral
TCGACCTCATTCTCTA	endoderm_postMG_dorsal
TCGACGGAGCACTAAA	endoderm_postMG_lateral
TCGACGGCATGAAGCG	endoderm_postMG_lateral
TCGATTTTCCTGCCAT	endoderm_postMG_dorsal
TCGCACTTCGCTCTCA	ectoderm_PS14_ventral
TCGCAGGGTACAAGTA	ectoderm_PS14_dorsal
TCGCTCACACCAAAGG	endoderm_postMG_dorsal
TCGCTCAGTTGTGTTG	endoderm_postMG_dorsal
TCGCTTGAGTAACCGG	ectoderm_hindgut_dorsal
TCGGGACCATCGAGCC	ectoderm_PS14_ventral
TCGGGACGTCACTCGG	endoderm_postMG_dorsal
TCGGGTGAGCCAGTAG	ectoderm_PS14_dorsal
TCGGTCTAGCGATCGA	endoderm_postMG_ventral
TCGGTCTCAGGCACAA	endoderm_postMG_lateral
TCGGTCTCATTGGGAG	endoderm_postMG_lateral
TCGTAGAAGGCGAACT	ectoderm_hindgut_dorsal
TCGTAGAAGTCGTCTA	ectoderm_PS14/hindgut
TCGTCCAGTCTAGTGT	ectoderm_PS14_dorsal
TCGTGCTGTGGTCTGC	endoderm_postMG_lateral
TCGTGGGAGCCAGACA	ectoderm_hindgut_dorsal
TCGTGGGCAGGCAATG	ectoderm_hindgut_ventral
TCGTGGGGTAAGTTGA	endoderm_postMG_lateral
TCGTGGGGTCCATCTC	endoderm_postMG_lateral
TCTATACAGAGAGCCT	endoderm_postMG_dorsal
TCTATACAGCATCCTA	endoderm_postMG_lateral
TCTATACGTATCGTGT	ectoderm_PS14_ventral
TCTCACGAGCTCATAC	endoderm_postMG_lateral
TCTCACGTCCGAACGC	ectoderm_PS14_dorsal
TCTCAGCTCGATTGAC	ectoderm_PS14_dorsal
TCTCTGGTCTACCTTA	endoderm_postMG_ventral
TCTGCCAAGTGCCGAA	endoderm_postMG_dorsal
TCTGCCAGTGGCTACC	ectoderm_PS14/hindgut
TCTGGCTTCAAGAAAC	ectoderm_hindgut_ventral
TCTTAGTTCCGAGATT	endoderm_postMG_dorsal
TCTTCCTGTTATGACC	ectoderm_PS14_dorsal
TCTTGCGGTGGCTTGC	ectoderm_PS14_dorsal
TGAACGTAGACCTCCG	ectoderm_PS14_dorsal
TGAATCGTCCGAAATC	endoderm_postMG_ventral
TGACCCTAGCGAGTCA	endoderm_postMG_lateral
TGACCCTGTGAGACCA	endoderm_postMG_lateral
TGACCCTGTGCGCTCA	ectoderm_PS14_dorsal
TGACGCGGTCGCCTAG	endoderm_postMG_lateral
TGAGCATGTAACGGTG	endoderm_postMG_dorsal
TGAGCGCGTAGGATAT	ectoderm_PS14_dorsal
TGAGGGAAGTGCACTT	endoderm_postMG_lateral
TGAGGGAGTTTACTTC	endoderm_postMG_lateral
TGAGGTTAGGGCGAGA	ectoderm_PS14/hindgut
TGAGGTTGTAAGGAGA	ectoderm_hindgut_dorsal
TGATCTTAGACCAACG	endoderm_postMG_lateral
TGATCTTCACACCGCA	ectoderm_hindgut_ventral
TGATGCACAGTCAACT	endoderm_postMG_dorsal
TGATGCATCCCAACTC	ectoderm_hindgut_dorsal
TGATGGTAGGCGAACT	endoderm_postMG_lateral
TGATTCTCAGTGCCTG	ectoderm_PS14/hindgut
TGATTCTGTCTTGAAC	ectoderm_hindgut_dorsal
TGCAGATAGAACTTCC	ectoderm_hindgut_dorsal
TGCATCCAGGTAGGCT	ectoderm_hindgut_dorsal
TGCATCCAGGTCGACA	endoderm_postMG_dorsal
TGCCGAGAGGGAACAA	endoderm_postMG_dorsal
TGCCGAGAGTCCCAGC	endoderm_postMG_ventral
TGCGACGCATTCACCC	endoderm_postMG_lateral
TGCGATATCACCCTGT	endoderm_postMG_ventral
TGCGGCAAGGTAAACT	endoderm_postMG_ventral
TGCGGCAGTGCGACAA	ectoderm_hindgut_ventral
TGCTCCATCCCAATAG	ectoderm_hindgut_dorsal
TGCTCGTCACCAACAT	endoderm_postMG_lateral
TGCTCGTGTTACGTAC	endoderm_postMG_dorsal
TGCTGAAAGGTTCCGC	endoderm_postMG_dorsal
TGCTTCGAGCCATTGT	endoderm_postMG_lateral
TGCTTCGGTAACCCTA	endoderm_postMG_dorsal
TGGAACTTCCTACCAC	endoderm_postMG_ventral
TGGAGAGAGGATACCG	endoderm_postMG_lateral
TGGAGAGAGTTCATCG	endoderm_postMG_lateral
TGGAGAGGTGCCGTAC	ectoderm_PS14_ventral
TGGAGAGTCGATTGGT	endoderm_postMG_ventral
TGGATCATCGTGCTCT	endoderm_postMG_dorsal
TGGCGTGCACCTGATA	endoderm_postMG_lateral
TGGCGTGTCGGCCTTT	endoderm_postMG_ventral
TGGGAAGAGTGATAAC	endoderm_postMG_dorsal
TGGGAAGCAACCCTAA	endoderm_postMG_lateral
TGGGAGACAACTCCCT	endoderm_postMG_dorsal
TGGGATTTCTATCCAT	endoderm_postMG_dorsal
TGGTAGTAGATAGCTA	endoderm_postMG_lateral
TGGTAGTTCTCGTCGT	endoderm_postMG_lateral
TGGTGATAGTGACACG	endoderm_postMG_ventral
TGTAACGAGAGCTTTC	ectoderm_hindgut_dorsal
TGTACAGGTTGAGGAC	endoderm_postMG_ventral
TGTCAGAGTATCGAGG	ectoderm_hindgut_dorsal
TGTCAGATCAACGAGG	endoderm_postMG_dorsal
TGTCCACAGGTACTGG	endoderm_postMG_dorsal
TGTCCACTCACTGAAC	endoderm_postMG_lateral
TGTCCCAGTTACACAC	ectoderm_hindgut_ventral
TGTCCTGAGAGAGGGC	ectoderm_hindgut_dorsal
TGTCCTGAGGAAGTCC	ectoderm_PS14_ventral
TGTGAGTCAGTTCTAG	endoderm_postMG_lateral
TGTGATGAGAGAGTTT	endoderm_postMG_dorsal
TGTGATGTCTCAACCC	ectoderm_hindgut_dorsal
TGTGGCGCAGGTGAGT	ectoderm_PS14_ventral
TGTTACTCATGTAACC	ectoderm_hindgut_ventral
TGTTCCGCACGTAGAG	endoderm_postMG_ventral
TGTTCTAAGAAAGTCT	ectoderm_PS14_ventral
TGTTGAGCAGGCCTGT	ectoderm_hindgut_ventral
TGTTGGACACGTCATA	endoderm_postMG_ventral
TGTTGGACAGCTCCTT	ectoderm_hindgut_dorsal
TGTTGGATCGGACGTC	ectoderm_PS14_dorsal
TTAATCCTCTACTCAT	endoderm_postMG_lateral
TTACAGGAGCCTGCCA	endoderm_postMG_lateral
TTACAGGAGGGTGAAA	endoderm_postMG_lateral
TTACGCCAGGTAAGTT	ectoderm_hindgut_ventral
TTACGCCTCCGTACGG	ectoderm_PS14/hindgut
TTACGTTTCCTCTGCA	endoderm_postMG_lateral
TTACTGTCAAGACGAC	endoderm_postMG_ventral
TTACTGTCACACAGAG	endoderm_postMG_lateral
TTAGGCAGTAGATTAG	endoderm_postMG_dorsal
TTAGGCAGTTGCTTGA	endoderm_postMG_dorsal
TTAGGGTAGCCTGGAA	ectoderm_PS14_dorsal
TTAGTCTAGCCTATCA	amnioserosa_PS14
TTCAATCCAATTAGGA	ectoderm_PS14/hindgut
TTCACCGGTTGGAGGT	endoderm_postMG_lateral
TTCACGCAGGAATGTT	endoderm_postMG_dorsal
TTCACGCCAAGATTGA	ectoderm_PS14_dorsal
TTCAGGAGTACATACC	endoderm_postMG_dorsal
TTCATTGTCACTCGAA	ectoderm_PS14_dorsal
TTCCAATGTTGGAGGT	ectoderm_PS14/hindgut
TTCCAATTCGGTCGAC	ectoderm_PS14/hindgut
TTCCACGTCGGTCACG	ectoderm_PS14_dorsal
TTCCGGTGTGACGTCC	endoderm_postMG_dorsal
TTCCTAACAACTCCAA	endoderm_postMG_dorsal
TTCCTAATCAGTGTCA	endoderm_postMG_dorsal
TTCCTAATCCGTGGTG	endoderm_postMG_dorsal
TTCCTCTAGCAAACAT	endoderm_postMG_dorsal
TTCCTCTGTATAGCTC	ectoderm_PS14/hindgut
TTCCTTCAGGCTTAAA	ectoderm_PS14_ventral
TTCCTTCCAACTGCTA	ectoderm_PS14_dorsal
TTCGATTTCCCTTCCC	endoderm_postMG_lateral
TTCGCTGGTCCAGCGT	endoderm_postMG_ventral
TTCGGTCCACGTTCGG	ectoderm_PS14_dorsal
TTCTAACGTGTAAACA	ectoderm_PS14_dorsal
TTCTAACTCATTGGTG	ectoderm_PS14_dorsal
TTGAACGAGAGAACCC	endoderm_postMG_lateral
TTGAACGGTCGAGATG	endoderm_postMG_ventral
TTGAACGGTTATGTCG	endoderm_postMG_lateral
TTGACCCAGTTGCATC	ectoderm_hindgut_dorsal
TTGAGTGAGCCATCCG	ectoderm_hindgut_ventral
TTGATGGCAGAGTCAG	ectoderm_PS14/hindgut
TTGATGGTCTCATTTG	ectoderm_PS14_ventral
TTGCTGCAGCAGCAGT	endoderm_postMG_lateral
TTGGATGGTAAGGAGA	endoderm_postMG_lateral
TTGTGGAAGGAATTAC	ectoderm_PS14_dorsal
TTGTGTTGTATACGGG	ectoderm_hindgut_dorsal
TTGTTCACATCACCAA	ectoderm_PS14_ventral
TTGTTTGCAGGATCTT	endoderm_postMG_ventral
TTGTTTGGTGCAGATG	endoderm_postMG_dorsal
TTTACCAGTAGGCTGA	ectoderm_hindgut_dorsal
TTTACCAGTCAACACT	ectoderm_PS14_ventral
TTTACCATCCTACACC	endoderm_postMG_dorsal
TTTACCATCTCCAAGA	endoderm_postMG_dorsal
TTTACGTAGCGAGGAG	ectoderm_hindgut_dorsal
TTTACGTTCGCTGTCT	amnioserosa_PS14
TTTACGTTCTTGCGCT	endoderm_postMG_ventral
TTTACTGGTCCGTTTC	ectoderm_PS14_ventral
TTTAGTCAGAAACCCG	endoderm_postMG_dorsal
TTTAGTCAGATGCTTC	endoderm_postMG_lateral
TTTCACAAGGCCCAAA	ectoderm_PS14_ventral
TTTCACACAAGCAATA	ectoderm_hindgut_dorsal
TTTCACATCGTTGCCT	ectoderm_PS14_ventral
TTTCACATCTGATGGT	endoderm_postMG_dorsal
TTTCAGTCATGACTAC	endoderm_postMG_dorsal
TTTCATGAGGTCGTGA	amnioserosa_PS14
TTTCCTCAGACTGTTC	endoderm_postMG_lateral
TTTCGATAGAAGCCAC	endoderm_postMG_dorsal
TTTCGATGTGAGTGAC	ectoderm_hindgut_ventral
TTTCGATGTGCAATAA	endoderm_postMG_ventral
TTTGGTTTCTGGCTGG	ectoderm_hindgut_ventral
TTTGTTGTCCACCTCA	ectoderm_hindgut_ventral
