manual_ID
AAAGGATCAGGCACAA	mesoderm_PS14
AACACACAGGTCGCCT	mesoderm_PS14
AACACACGTGGCATCC	mesoderm_caudal_visceral
AACGAAAAGCCATTTG	mesoderm_caudal_visceral
AAGCGAGAGGAGCAAA	mesoderm_PS14
AATCGACGTCAACACT	mesoderm_PS14
ACAAAGATCTCATTTG	mesoderm_caudal_visceral
ACAACCACACCTGCAG	mesoderm_caudal_visceral
ACACGCGCAGTAACGG	mesoderm_PS14/mesoderm_caudal_visceral
ACAGGGACACCGGCTA	mesoderm_PS14
ACAGGGACAGTAGAAT	mesoderm_PS14/mesoderm_caudal_visceral
ACAGGGAGTCAGCTTA	mesoderm_PS14
ACATTTCCATCGAGCC	mesoderm_PS14/mesoderm_caudal_visceral
ACCCTCAAGTGCTAGG	mesoderm_PS14
ACCTGAAAGATGGGCT	mesoderm_PS14
ACGGTTACAGACCTGC	mesoderm_PS14
ACGTAACGTATGTGTC	mesoderm_PS14
ACTGTGAAGCGTTCAT	mesoderm_PS14/mesoderm_caudal_visceral
AGACAGGCACTTACAG	mesoderm_PS14
AGACAGGGTCGCATCG	mesoderm_caudal_visceral
AGAGAGCGTAGCCAGA	mesoderm_caudal_visceral
AGAGCAGAGACGTCGA	mesoderm_caudal_visceral
AGATGCTGTCGTGATT	mesoderm_PS14/mesoderm_caudal_visceral
AGATGCTTCGAGCCAC	mesoderm_PS14
AGCGATTAGGACAGTC	mesoderm_caudal_visceral
AGGAAATGTCAACATC	mesoderm_PS14
AGGATCTAGTACAGAT	mesoderm_PS14
AGTCAACTCCCAGCGA	mesoderm_PS14
AGTCACATCGAGATAA	mesoderm_PS14
AGTCATGTCCCATTCG	mesoderm_caudal_visceral
AGTTCGAAGTTGGCTT	mesoderm_caudal_visceral
ATACTTCAGTATTGCC	mesoderm_PS14
ATAGACCTCCACCTGT	mesoderm_caudal_visceral
ATCATTCTCTCCGATC	mesoderm_PS14
ATGGGTTGTTGGGATG	mesoderm_caudal_visceral
ATGGTTGGTACCATAC	mesoderm_PS14
ATGTCTTGTATAATGG	mesoderm_PS14
ATTACCTTCGTTCTGC	mesoderm_PS14
ATTATCCCATAAGCAA	mesoderm_PS14
ATTCATCAGTCGAAAT	mesoderm_PS14
ATTCCATGTCCATACA	mesoderm_PS14
ATTCGTTTCCTTCTTC	mesoderm_caudal_visceral
CAATACGGTTGCCGAC	mesoderm_caudal_visceral
CAATTTCAGAGAGAAC	mesoderm_PS14
CACTAAGCAGGGAGAG	mesoderm_caudal_visceral
CAGATTGAGCGCCTCA	mesoderm_caudal_visceral
CATCAAGAGTACTCGT	mesoderm_PS14
CATCGTCCAAAGCTAA	mesoderm_PS14/mesoderm_caudal_visceral
CATGAGTTCCGGTAAT	mesoderm_PS14
CATGCAAAGACGCCAA	mesoderm_caudal_visceral
CATTGCCCACTTCAAG	mesoderm_PS14
CATTGCCCATGGACAG	mesoderm_caudal_visceral
CATTGTTTCGCCGAGT	mesoderm_PS14
CCACTTGTCCTCGATC	mesoderm_PS14
CCCTGATCATCTAGAC	mesoderm_PS14
CCCTTAGCAGCATCTA	mesoderm_PS14
CCCTTAGGTGCTAGCC	mesoderm_PS14/mesoderm_caudal_visceral
CCGGACAAGAGGGCGA	mesoderm_PS14
CCGGGTAAGGATTCCT	mesoderm_PS14/mesoderm_caudal_visceral
CCGGTAGGTAGCCCTG	mesoderm_caudal_visceral
CCTCACACACGTAACT	mesoderm_caudal_visceral
CCTCAGTTCGGATACT	mesoderm_PS14
CCTCCTCGTCCAGCCA	mesoderm_caudal_visceral
CCTCTAGGTACGGATG	mesoderm_caudal_visceral
CGAAGGATCAACCGAT	mesoderm_PS14
CGAAGTTGTTCTCTAT	mesoderm_PS14
CGAGGCTAGGATTTAG	mesoderm_caudal_visceral
CGCCAGATCCACCTGT	mesoderm_caudal_visceral
CGGGTCACACATTACG	mesoderm_PS14/mesoderm_caudal_visceral
CGTAAGTGTAATGCTC	mesoderm_PS14
CGTCCATAGTCTAGCT	mesoderm_caudal_visceral
CGTGAATCATGCACTA	mesoderm_caudal_visceral
CGTGATAGTCACAGTT	mesoderm_PS14
CTACATTGTCATCCGG	mesoderm_PS14
CTACGGGCAGATACCT	mesoderm_PS14
CTATAGGAGATGTTAG	mesoderm_caudal_visceral
CTATAGGAGGAGCTGT	mesoderm_PS14
CTATCTAAGCACCAGA	mesoderm_PS14/mesoderm_caudal_visceral
CTCATCGCAATTCTTC	mesoderm_PS14
CTCATGCGTCATCGGC	mesoderm_PS14/mesoderm_caudal_visceral
CTCATTAGTTACGCCG	mesoderm_caudal_visceral
CTCTCGACATACCACA	mesoderm_PS14
CTGAGGCAGCGCCTTG	mesoderm_PS14/mesoderm_caudal_visceral
CTGCAGGGTCTACATG	mesoderm_PS14
CTGCCATGTCCGGCAT	mesoderm_caudal_visceral
CTTACCGAGCCTTCTC	mesoderm_PS14
CTTAGGAAGTTCATCG	mesoderm_PS14
CTTGAGATCCGAAGGA	mesoderm_PS14
GAATCACGTGTGTGTT	mesoderm_PS14
GACACGCAGCTCATAC	mesoderm_PS14/mesoderm_caudal_visceral
GACAGCCCAGAGATTA	mesoderm_PS14
GACCGTGGTATACCCA	mesoderm_PS14
GACCGTGTCTAGCATG	mesoderm_PS14
GACTCTCAGAGTATAC	mesoderm_caudal_visceral
GACTGATGTGTAGCAG	mesoderm_PS14
GAGACTTAGCCGTTAT	mesoderm_PS14/mesoderm_caudal_visceral
GAGACTTAGTGGTTCT	mesoderm_caudal_visceral
GAGTCATTCTACGCAA	mesoderm_caudal_visceral
GAGTGTTTCGTGCATA	mesoderm_caudal_visceral
GAGTTACTCAAAGACA	mesoderm_caudal_visceral
GATGACTAGTCCTGCG	mesoderm_PS14
GCAGCTGTCAGCAATC	mesoderm_caudal_visceral
GCAGTTAGTCGACTGC	mesoderm_PS14
GCATGATTCTTGCAGA	mesoderm_PS14
GCCAGCAAGTTGGAGC	mesoderm_caudal_visceral
GCCAGGTTCTGCGTCT	mesoderm_PS14
GCCCAGAGTGCCCTTT	mesoderm_PS14/mesoderm_caudal_visceral
GCCGATGAGGTACAAT	mesoderm_caudal_visceral
GCGAGAACACATCATG	mesoderm_PS14/mesoderm_caudal_visceral
GCGGAAAAGAGAGTGA	mesoderm_PS14
GCGTGCAGTCGCCTAG	mesoderm_PS14
GCTCAAAGTCAGCGTC	mesoderm_PS14
GGAGCAAGTTGTTTGG	mesoderm_PS14
GGGAAGTCACCAGCTG	mesoderm_PS14/mesoderm_caudal_visceral
GGGACTCGTGATACTC	mesoderm_PS14
GGGTCACTCCGTATGA	mesoderm_PS14
GGGTGAAAGGAACGTC	mesoderm_caudal_visceral
GGTAATCGTGTGCTTA	mesoderm_PS14/mesoderm_caudal_visceral
GGTCACGAGCACGATG	mesoderm_PS14
GGTCTGGTCCCATACC	mesoderm_PS14
GTAATCGAGGTACCTT	mesoderm_PS14
GTACAACAGAACTGAT	mesoderm_PS14
GTACAGTTCGCTGTTC	mesoderm_PS14
GTAGATCGTTGTGTAC	mesoderm_PS14/mesoderm_caudal_visceral
GTAGATCTCGCTTTAT	mesoderm_PS14
GTAGCTATCCACTGGG	mesoderm_PS14
GTCAAGTCACAGAGCA	mesoderm_PS14
GTCACGGTCACGAACT	mesoderm_PS14
GTGAGCCAGGTGCATG	mesoderm_caudal_visceral
GTGTAACCATGCCGGT	mesoderm_PS14
GTGTTCCAGCACTAAA	mesoderm_PS14
GTGTTCCCAAGCCTGC	mesoderm_PS14
GTTACGATCACAAGAA	mesoderm_PS14
GTTACGATCATCCCGT	mesoderm_PS14
GTTAGTGGTACGACTT	mesoderm_PS14
GTTCCGTAGCTGACTT	mesoderm_caudal_visceral
GTTGTGACATAGCTGT	mesoderm_PS14/mesoderm_caudal_visceral
TAACACGAGTCACTAC	mesoderm_caudal_visceral
TAACTTCTCTCGGTCT	mesoderm_PS14/mesoderm_caudal_visceral
TAAGCACGTGAGTGAC	mesoderm_caudal_visceral
TAATCTCTCGTGCATA	mesoderm_PS14/mesoderm_caudal_visceral
TACACCCAGAAGCTGC	mesoderm_caudal_visceral
TACATTCTCTCGCGTT	mesoderm_PS14
TACTTACTCCGCAGTG	mesoderm_PS14/mesoderm_caudal_visceral
TATATCCTCATTTGTC	mesoderm_PS14/mesoderm_caudal_visceral
TATTGCTAGATTAGCA	mesoderm_PS14
TATTTCGCACGCGTGT	mesoderm_caudal_visceral
TCAATCTAGCACGTCC	mesoderm_caudal_visceral
TCAGCAACATCCGCGA	mesoderm_caudal_visceral
TCAGCAACATGTTCAG	mesoderm_PS14/mesoderm_caudal_visceral
TCAGTCCAGGAGCAAA	mesoderm_PS14
TCATACTCAAGTCGTT	mesoderm_PS14
TCATATCGTGGCGTAA	mesoderm_PS14
TCATCATTCCGTGACG	mesoderm_caudal_visceral
TCCATCGAGACTGAGC	mesoderm_caudal_visceral
TCCCATGAGTCTGGAG	mesoderm_caudal_visceral
TCCGATCGTACCGGCT	mesoderm_PS14
TCCGGGATCATTCACT	mesoderm_PS14
TCCTCGAAGAGGGTGG	mesoderm_caudal_visceral
TCGATTTAGAAGCGAA	mesoderm_PS14
TCGGGCAGTAGAGATT	mesoderm_PS14
TCGTAGAGTATAGGGC	mesoderm_PS14
TCGTAGAGTTTCACTT	mesoderm_PS14
TCGTGGGAGAAGTCCG	mesoderm_PS14/mesoderm_caudal_visceral
TCGTGGGCAGTTTGGT	mesoderm_PS14
TCTATCAGTCAGTCTA	mesoderm_PS14
TCTGCCAAGGAATGTT	mesoderm_PS14
TCTGCCATCGCCGATG	mesoderm_PS14
TCTGTCGCAGTGGGTA	mesoderm_caudal_visceral
TCTTGCGAGACATGCG	mesoderm_caudal_visceral
TGAATCGGTCATTGCA	mesoderm_PS14
TGAATGCTCCCTGGTT	mesoderm_caudal_visceral
TGACCCTCACAATGCT	mesoderm_PS14
TGACCCTCACGTATAC	mesoderm_PS14/mesoderm_caudal_visceral
TGAGACTGTATTCCTT	mesoderm_PS14
TGAGCATAGCAATTAG	mesoderm_PS14
TGAGGTTCACCTATCC	mesoderm_PS14
TGATCTTCAGACACCC	mesoderm_caudal_visceral
TGCATGACAGCTCTGG	mesoderm_PS14
TGCCGAGAGCAGCAGT	mesoderm_PS14
TGCGATACACTGTCCT	mesoderm_PS14/mesoderm_caudal_visceral
TGCGATATCAGGAAGC	mesoderm_PS14
TGCGGCAAGGGCAGTT	mesoderm_PS14
TGCTCCAAGGAGGCAG	mesoderm_PS14
TGCTCGTCACAAGTTC	mesoderm_PS14/mesoderm_caudal_visceral
TGGAACTTCGGAATGG	mesoderm_PS14
TGGGCGTCAGAACGCA	mesoderm_PS14
TGGTAGTCACCTGTCT	mesoderm_PS14
TGTGAGTTCTTGCAAG	mesoderm_caudal_visceral
TGTGATGAGTATGGCG	mesoderm_caudal_visceral
TGTGGCGCAGAGAAAG	mesoderm_PS14/mesoderm_caudal_visceral
TGTTGAGTCACACCGG	mesoderm_caudal_visceral
TTACGCCAGTTGGACG	mesoderm_PS14/mesoderm_caudal_visceral
TTATTGCGTTCCTAGA	mesoderm_PS14
TTCACCGGTGCGTGCT	mesoderm_PS14
TTCAGGAAGGGAGAAT	mesoderm_caudal_visceral
TTCCAATAGGCCGCTT	mesoderm_caudal_visceral
TTCCTTCCACTTCAGA	mesoderm_PS14/mesoderm_caudal_visceral
TTCGCTGGTACTCAAC	mesoderm_PS14
TTGAGTGCACCAGTAT	mesoderm_PS14
TTGATGGCATCGCTCT	mesoderm_caudal_visceral
TTGCATTTCGCCACTT	mesoderm_PS14
TTGCTGCCACAGCGCT	mesoderm_PS14
TTGGATGGTTACCTTT	mesoderm_PS14
TTGGGATGTATTAAGG	mesoderm_PS14
TTTACTGGTATAATGG	mesoderm_caudal_visceral
TTTCGATAGGTAAGGA	mesoderm_caudal_visceral
