manual_ID
AAAGAACGTGTTCGTA	endoderm_antMG_wntD
AACACACTCGTGGAAG	mesoderm_head
AACCTTTCACCCTCTA	endoderm_antMG_wntD
AATGCCAAGTCAGGGT	mesoderm_head
ACACAGTAGAAGGATG	mesoderm_head
ACAGCCGGTTAGGCTT	endoderm_antMG_wntD
ACATCCCGTTACTCAG	mesoderm_head
ACCAACACACGGTCTG	endoderm_antMG_wg
ACCACAAGTACCTGTA	endoderm_antMG_wntD
ACGATGTCAACGGTAG	mesoderm_head
ACGGTCGCAAGAGGCT	endoderm_antMG_wntD
ACTGCAACAAACTAAG	mesoderm_head
ACTTCCGCAAAGAGTT	mesoderm_head
AGACCCGAGGACACTG	endoderm_antMG_wntD
AGAGCAGGTCTGGTTA	endoderm_antMG_wntD
AGCGATTCATGTGCTA	mesoderm_head
AGCGCCAGTACGCGTC	endoderm_antMG_wntD
AGGAAATAGCTTTCCC	mesoderm_head
AGGCCACGTTGTTGCA	endoderm_antMG_wntD
AGGGCCTTCTACGCAA	endoderm_antMG_wntD
AGGGTTTAGCGAACTG	endoderm_antMG_wg
AGGTTACCATCATGAC	endoderm_antMG_wntD
AGGTTGTGTTGCTTGA	endoderm_antMG_wntD
AGTCATGCACCGTGCA	endoderm_antMG_wntD
ATAGAGACACAAATAG	endoderm_antMG_wntD
ATCCTATTCTCCAATT	mesoderm_head
ATCGTCCTCTTCTAAC	endoderm_antMG_wg
ATCTCTAAGCACCTGC	endoderm_antMG_wg
ATGGAGGTCTGGCTGG	endoderm_antMG_wg
ATTACCTGTGGATGAC	endoderm_antMG_wg
ATTGTTCGTGCACAAG	endoderm_antMG_wntD
ATTTCTGTCCGTCAAA	endoderm_antMG_wntD
CAATGACTCCCTCATG	endoderm_antMG_wg
CACACAATCACGGACC	mesoderm_head
CAGCCAGAGCCTCATA	mesoderm_head
CATAAGCCACACGGTC	mesoderm_head
CATACTTCACTTTAGG	endoderm_antMG_wntD
CATCAAGCAGATAAAC	mesoderm_head
CATCCGTGTACTGAGG	mesoderm_head
CATCGCTAGTTCCGTA	mesoderm_head
CATCGCTCATTGTAGC	mesoderm_head
CATTCATAGCTATCCA	endoderm_antMG_wntD
CATTGTTTCGCTTAAG	mesoderm_head
CCACGAGGTCTGTAGT	endoderm_antMG_wntD
CCACGTTGTACAAGTA	endoderm_antMG_wg
CCACTTGTCAAGGACG	endoderm_antMG_wg
CCATAAGAGGCACTAG	mesoderm_head
CCGATGGAGTGCCCGT	mesoderm_head
CCGGTAGGTGGATACG	mesoderm_head
CCTCTCCGTGGTTTAC	endoderm_antMG_wg
CGACAGCAGCTGTACT	endoderm_antMG_wg
CGAGAAGAGGAACGAA	mesoderm_head
CGGAATTTCTAGGAAA	mesoderm_head
CGGAGAATCAGCTAGT	mesoderm_head
CGGAGAATCCCTCGTA	mesoderm_head
CGGGTGTAGGCCTGAA	endoderm_antMG_wntD
CTATCTAGTGAGGAAA	endoderm_antMG_wntD
CTCAGTCCATGTACGT	endoderm_antMG_wntD
CTCCCTCAGCTCCATA	endoderm_antMG_wg
CTCCGATCAATTGCAC	endoderm_antMG_wg
CTCGAGGTCTCCATAT	endoderm_antMG_wg
CTCTCAGAGTGTCATC	endoderm_antMG_wntD
CTCTGGTCAGCTAACT	endoderm_antMG_wg
CTGCAGGGTACGCGTC	endoderm_antMG_wntD
CTTCCGAAGACTTCAC	endoderm_antMG_wntD
CTTCCTTAGAGTGAAG	mesoderm_head
GAACGTTAGTCACAGG	endoderm_antMG_wg
GACCGTGAGTTGAAGT	endoderm_antMG_wg
GACGCTGCATCCTGTC	mesoderm_head
GACGCTGTCCACGAAT	endoderm_antMG_wg
GAGACCCGTCTACTGA	mesoderm_head
GAGCTGCAGAGCACTG	mesoderm_head
GAGTCTAAGTATTGCC	mesoderm_head
GAGTTACTCTGAGTCA	endoderm_antMG_wntD
GATGATCTCATGCCCT	mesoderm_head
GATTGGTCAGACAAGC	endoderm_antMG_wntD
GCACGGTTCGACTCCT	endoderm_antMG_wg
GCCGATGTCAGATTGC	endoderm_antMG_wntD
GCCGTGACACGGCACT	endoderm_antMG_wg
GCTACCTGTGTGCTTA	mesoderm_head
GCTTCACAGGTCCGAA	endoderm_antMG_wntD
GCTTTCGTCGTTGTTT	endoderm_antMG_wntD
GGAAGTGGTCAAATCC	endoderm_antMG_wg
GGAGGTATCAAATGCC	mesoderm_head
GGGACTCCAAAGAGTT	endoderm_antMG_wg
GGTCTGGGTGTGTGGA	endoderm_antMG_wg
GGTCTGGTCTCGAACA	endoderm_antMG_wntD
GGTGATTCATAGATGA	mesoderm_head
GGTTAACGTTGTCATG	mesoderm_head
GGTTGTAGTAGCGTCC	mesoderm_head
GTAAGTCTCTCGTGAA	endoderm_antMG_wntD
GTAGTACGTAGCGTTT	endoderm_antMG_wntD
GTCATCCAGAAGCCAC	endoderm_antMG_wntD
GTCTCACCACAAGCAG	mesoderm_head
GTCTCACCACATGACT	endoderm_antMG_wg
GTGCAGCGTAATCAGA	endoderm_antMG_wg
TAATTCCGTCGAGTTT	mesoderm_head
TACCTCGAGAAACACT	endoderm_antMG_wntD
TAGACCAGTAATACCC	endoderm_antMG_wntD
TATTGGGCAACCGGAA	endoderm_antMG_wntD
TCAAGCATCTGGAGAG	mesoderm_head
TCATCATCAATCCTAG	mesoderm_head
TCATCATGTCGCATCG	endoderm_antMG_wg
TCATTTGAGATGAAGG	endoderm_antMG_wntD
TCCGGGACAGCTTTGA	endoderm_antMG_wg
TCGCTTGCAGCTTCGG	endoderm_antMG_wntD
TCGGATATCAGCGTCG	mesoderm_head
TCTATCACAAGCCTGC	endoderm_antMG_wntD
TCTCCGAAGTCTTCCC	endoderm_antMG_wntD
TGAGACTAGTTAGTGA	endoderm_antMG_wntD
TGATCAGAGGCACGAT	mesoderm_head
TGATCAGTCCGTGTGG	mesoderm_head
TGATGCATCTGTGCGG	endoderm_antMG_wg
TGATGGTTCACTCACC	mesoderm_head
TGCGGCATCGGAATTC	endoderm_antMG_wg
TGCTTGCAGACTGAGC	endoderm_antMG_wntD
TGGAGAGGTGCAATAA	endoderm_antMG_wg
TGGGAGATCTATACTC	endoderm_antMG_wg
TGGGCTGTCACAGAGG	mesoderm_head
TGGGTTAGTCTACTGA	endoderm_antMG_wg
TGTGTGAAGAGTCTTC	endoderm_antMG_wntD
TTACCATTCGTGCATA	endoderm_antMG_wntD
TTAGGCAGTCCGGTGT	endoderm_antMG_wg
TTCCGGTCAGACTCTA	mesoderm_head
TTGCATTAGCGTCAAG	mesoderm_head
TTTCATGTCTCGGGAC	endoderm_antMG_wntD
TTTGGTTAGGAGTACC	endoderm_antMG_wntD
TTTGTTGCAGGCATTT	endoderm_antMG_wntD
