manual_ID
AAACGCTCAGCCCACA	mesoderm_gcm_Dfd
AAAGTGATCTATCACT	mesoderm_gcm
AACCTTTTCGAGAACG	mesoderm_gcm
AACTTCTGTAGTGGCA	mesoderm_gcm_Dfd
AAGAACAAGCAGGTCA	mesoderm_gcm
AAGATAGTCACTCTTA	mesoderm_gcm
AAGGAATGTCTGTCCT	mesoderm_gcm
AATCACGAGCTCCCTT	mesoderm_gcm
AATTTCCTCAGCTTCC	mesoderm_gcm
ACAGGGACAGCAGTTT	mesoderm_gcm
ACAGGGATCCGGGACT	mesoderm_gcm
ACCCTTGTCTCTATAC	mesoderm_gcm
ACGATGTGTGTCTAAC	mesoderm_gcm_Dfd
ACTACGAGTGACCTGC	mesoderm_gcm_Dfd
ACTCTCGGTAGTGCGA	mesoderm_gcm
ACTGATGTCGACGTCG	mesoderm_gcm_Dfd
ACTTCGCAGAGTTGTA	mesoderm_gcm
AGACCATTCAGCGCAC	mesoderm_gcm_Dfd
AGATCCAAGCGCAATG	mesoderm_gcm
AGCGTATTCATGCATG	mesoderm_gcm
AGGAATAAGCTTGTTG	mesoderm_gcm
AGGATAAAGCTGACAG	mesoderm_gcm
AGGGCCTTCCGGGACT	mesoderm_gcm_Dfd
AGTGACTCAGAAGTGC	mesoderm_gcm_Dfd
AGTGACTGTCAAAGAT	mesoderm_gcm
AGTGCCGAGGCACCAA	mesoderm_gcm
ATAGAGATCATAGCAC	mesoderm_gcm
ATATCCTCATACCATG	mesoderm_gcm
ATCAGGTCACCTGCTT	mesoderm_gcm_Dfd
ATCCACCGTTAGAAGT	mesoderm_gcm_Dfd
ATCCATTCATGGACAG	mesoderm_gcm
ATCCCTGTCGAGTGGA	mesoderm_gcm
ATCGTGACACTGAATC	mesoderm_gcm
ATGACCACACAACCGC	mesoderm_gcm
ATGAGTCTCACTGTTT	mesoderm_gcm_Dfd
ATGCCTCGTTGCATAC	mesoderm_gcm
ATGGAGGTCACCTCGT	mesoderm_gcm_Dfd
ATGGATCTCGAAGCAG	mesoderm_gcm
ATGGGTTGTACGGGAT	mesoderm_gcm
ATTATCCAGGTATTGA	mesoderm_gcm
ATTATCCGTGCGTTTA	mesoderm_gcm
CAACAACCACACACTA	mesoderm_gcm_Dfd
CAACCAATCTTGCAGA	mesoderm_gcm
CAACGGCCACACGCCA	mesoderm_gcm
CAATGACAGAAATGGG	mesoderm_gcm
CACAGATCAACCCGCA	mesoderm_gcm
CACTGAAAGTTACGTC	mesoderm_gcm
CACTGTCGTAGTTAGA	mesoderm_gcm
CAGATACGTTCTCAGA	mesoderm_gcm_Dfd
CAGTGCGGTAGCTTAC	mesoderm_gcm
CATCGGGAGTATCCTG	mesoderm_gcm
CCACGAGTCATATGGC	mesoderm_gcm
CCATAAGGTGGCCCAT	mesoderm_gcm_Dfd
CCCTGATGTAGATCCT	mesoderm_gcm_Dfd
CCCTGATTCATGGAGG	mesoderm_gcm_Dfd
CCGAACGAGGTAGTCG	mesoderm_gcm
CCGGGTAGTGATGAAT	mesoderm_gcm_Dfd
CCGGTAGCAGGACGAT	mesoderm_gcm
CCTACGTTCAATCTTC	mesoderm_gcm
CCTCACATCAGTCATG	mesoderm_gcm
CGAAGGATCTTGCAGA	mesoderm_gcm
CGAAGTTCAGATCCAT	mesoderm_gcm_Dfd
CGCATGGAGCGTGCCT	mesoderm_gcm
CGCCAGAAGCAATAGT	mesoderm_gcm
CGGGTCACAAGAAACT	mesoderm_gcm
CGTGCTTCATCCTTGC	mesoderm_gcm
CTACCCACAAGAGTTA	mesoderm_gcm
CTATAGGAGGCGTTAG	mesoderm_gcm_Dfd
CTATCCGAGAATTTGG	mesoderm_gcm
CTATCTAGTAGGATAT	mesoderm_gcm_Dfd
CTCAAGAAGGCGTCCT	mesoderm_gcm
CTCAATTCAGGAATAT	mesoderm_gcm
CTCATGCAGACAGTCG	mesoderm_gcm
CTCATGCGTGATCGTT	mesoderm_gcm
CTGTACCAGTCCGCGT	mesoderm_gcm_Dfd
CTGTATTTCCTACGGG	mesoderm_gcm
CTTCAATAGGTACAAT	mesoderm_gcm
CTTCGGTAGCCTGGAA	mesoderm_gcm_Dfd
CTTCGGTTCCGAACGC	mesoderm_gcm
CTTCTAATCGAGAAAT	mesoderm_gcm_Dfd
CTTGAGAGTCGACGCT	mesoderm_gcm_Dfd
GAAACCTGTCTCGGGT	mesoderm_gcm
GAACTGTCAATCGCAT	mesoderm_gcm_Dfd
GAAGCCCCAGCTACCG	mesoderm_gcm
GACAGCCAGCATCCTA	mesoderm_gcm
GACCGTGTCTCCTGTG	mesoderm_gcm_Dfd
GATTGGTTCGCTACGG	mesoderm_gcm
GATTTCTCACTTGTGA	mesoderm_gcm_Dfd
GCAACCGGTCACTAGT	mesoderm_gcm_Dfd
GCAGCTGAGATAGGGA	mesoderm_gcm
GCCGATGGTCGATTTG	mesoderm_gcm
GGAGGTAAGGAGTCTG	mesoderm_gcm
GGCGTCACACGAAGAC	mesoderm_gcm
GGGAGTAGTCTAGTGT	mesoderm_gcm
GGTTAACAGTGGATAT	mesoderm_gcm_Dfd
GTAACACGTCCTGAAT	mesoderm_gcm
GTAACCAGTTGTTGAC	mesoderm_gcm
GTACAGTTCTGGGCGT	mesoderm_gcm
GTATTGGCACCCTTAC	mesoderm_gcm
GTCAAACGTTCGGTCG	mesoderm_gcm
GTCAAGTCAGAGACTG	mesoderm_gcm_Dfd
GTCAGCGAGGTCATTC	mesoderm_gcm
GTGCAGCCAAATCGTC	mesoderm_gcm
GTGTAACAGGAATGTT	mesoderm_gcm
GTGTGGCAGACTACGG	mesoderm_gcm_Dfd
GTGTGGCAGGTACAGC	mesoderm_gcm
GTTAGACCAACGAGGT	mesoderm_gcm
TACCGGGTCTTCTCAA	mesoderm_gcm
TACTGCCGTGCGTTTA	mesoderm_gcm
TAGCACACAAGGTTGG	mesoderm_gcm
TATCTGTCATCCGTGG	mesoderm_gcm
TATTCCATCTTGAGCA	mesoderm_gcm
TCAAGTGTCTCGGCTT	mesoderm_gcm_Dfd
TCACTCGTCAGGTGTT	mesoderm_gcm_Dfd
TCATCATGTGACCTGC	mesoderm_gcm
TCATGCCGTCCATCTC	mesoderm_gcm
TCCTAATCATTGTCGA	mesoderm_gcm_Dfd
TCCTGCAAGTGGAAGA	mesoderm_gcm_Dfd
TCCTGCAGTACTCGTA	mesoderm_gcm
TCGACCTAGAGGACTC	mesoderm_gcm
TCGGATAAGGAATCGC	mesoderm_gcm_Dfd
TCTAACTAGTGATAGT	mesoderm_gcm_Dfd
TCTCAGCTCGACGACC	mesoderm_gcm_Dfd
TCTCTGGAGAGAGGGC	mesoderm_gcm
TGAACGTCATATGCGT	mesoderm_gcm
TGACTCCTCTATACGG	mesoderm_gcm
TGAGGGAGTTGCTGAT	mesoderm_gcm
TGAGGTTTCGCAGAGA	mesoderm_gcm_Dfd
TGATCAGTCCAATGCA	mesoderm_gcm
TGCACGGGTACAGAAT	mesoderm_gcm_Dfd
TGCAGTAAGCGATGCA	mesoderm_gcm_Dfd
TGGATGTTCCTCTAGC	mesoderm_gcm
TGGTAGTCAACTTGGT	mesoderm_gcm_Dfd
TGTTGGAAGGTGCTTT	mesoderm_gcm
TTACGTTCACGGCGTT	mesoderm_gcm
TTCACGCTCCGTTTCG	mesoderm_gcm
TTCATGTGTACTGAGG	mesoderm_gcm
TTCTTGATCATAGAGA	mesoderm_gcm_Dfd
TTGAACGAGTCCCAAT	mesoderm_gcm_Dfd
TTGAGTGTCAGGTAAA	mesoderm_gcm_Dfd
TTGCGTCTCCCTCTCC	mesoderm_gcm
TTGGATGGTAGATGTA	mesoderm_gcm_Dfd
TTTGGTTCAGTCAACT	mesoderm_gcm
