manual_ID
AAAGTCCCACTAGAGG	ectoderm_intermediate_NE_PS1
AACAAGAGTTCACCGG	ectoderm_medial_NE_PS1
AACCTGAAGCGACTGA	ectoderm_medial_DE_PS1
AAGAACAAGGAATTAC	ectoderm_intermediate_NE_PS1
AAGCCATAGCAGCCTC	ectoderm_intermediate_NE_PS1
AAGCGAGCAACAGCCC	ectoderm_medial_DE_PS1
AATCACGCATCGCTAA	ectoderm_medial_NE_PS1
AATCGACCATCCAATG	ectoderm_medial_NE_PS1
AATCGTGCATGTGTCA	ectoderm_intermediate_NE_PS1
AATTTCCAGTTCTACG	ectoderm_intermediate_NE_PS1
ACACAGTTCCGTATGA	ectoderm_medial_NE_PS1
ACAGCCGCATGGCACC	ectoderm_lateral_DE_PS1
ACATTTCCAGTAGGAC	ectoderm_medial_NE_PS1
ACATTTCGTATGGAAT	ectoderm_lateral_NE_PS1
ACCACAAAGCCGCACT	ectoderm_lateral_DE_PS1
ACCCAAAGTGCAGTGA	ectoderm_intermediate_NE_PS1
ACCCTTGAGGAAGTCC	ectoderm_lateral_DE_PS1
ACGTACAGTTCAGCGC	ectoderm_lateral_NE_PS1
ACGTCCTAGTTCACTG	ectoderm_lateral_DE_PS1
ACGTTCCTCCTCACGT	ectoderm_medial_DE_PS1
ACTATTCCAGCTCATA	ectoderm_lateral_NE_PS1
AGACACTCATCCGAGC	ectoderm_lateral_DE_PS1
AGACCATTCCATACTT	ectoderm_lateral_NE_PS1
AGAGCAGGTGAGATTA	ectoderm_medial_NE_PS1
AGCCAATTCGGTCATA	ectoderm_intermediate_NE_PS1
AGCCAGCGTCAAAGTA	ectoderm_lateral_NE_PS1
AGCGCTGGTCCTGGGT	ectoderm_lateral_DE_PS1
AGGATCTAGCTCGGCT	ectoderm_intermediate_NE_PS1
AGGGCTCAGGCTGAAC	ectoderm_medial_NE_PS1
AGGGTGACACATAACC	ectoderm_medial_DE_PS1
AGGGTTTAGACTCAAA	ectoderm_intermediate_NE_PS1
AGGTGTTAGAGAGCCT	ectoderm_medial_NE_PS1
AGTAGCTAGTGATCGG	ectoderm_lateral_NE_PS1
AGTAGTCCACGGATCC	ectoderm_medial_NE_PS1
AGTTAGCTCTACGCAA	ectoderm_lateral_NE_PS1
ATACCGACAGGTATGG	ectoderm_lateral_DE_PS1
ATACCGACATACCAGT	ectoderm_lateral_NE_PS1
ATCAGGTTCAAGGTGG	ectoderm_intermediate_NE_PS1
ATCATTCTCTCTTCAA	ectoderm_lateral_DE_PS1
ATCGATGTCTGCTGAA	ectoderm_medial_NE_PS1
ATCGCCTAGGCGAAGG	ectoderm_intermediate_NE_PS1
ATGCCTCCAATTTCGG	ectoderm_lateral_NE_PS1
ATGCGATAGAATCCCT	ectoderm_intermediate_NE_PS1
ATGCGATCACGTACAT	ectoderm_medial_NE_PS1
ATGGATCGTATGAGAT	ectoderm_lateral_NE_PS1
ATTATCCAGGAGAGTA	ectoderm_lateral_NE_PS1
ATTCCATGTACGATGG	ectoderm_medial_NE_PS1
ATTCCCGCACGTATAC	ectoderm_intermediate_NE_PS1
ATTGTTCAGCAGAAAG	ectoderm_lateral_DE_PS1
CAACCAAAGGCTAAAT	ectoderm_lateral_NE_PS1
CAAGCTAAGAGAGAAC	ectoderm_medial_NE_PS1
CAAGGGAGTGCTCTTC	ectoderm_intermediate_NE_PS1
CACAGATCATTAGGCT	ectoderm_intermediate_NE_PS1
CACAGATTCACCCTCA	ectoderm_medial_DE_PS1
CACGTGGCAAGCGCTC	ectoderm_lateral_NE_PS1
CACTGTCCAGCTGTGC	ectoderm_lateral_NE_PS1
CAGATCAGTTTGACAC	ectoderm_medial_DE_PS1
CATACTTAGAGAACCC	ectoderm_intermediate_NE_PS1
CATACTTGTCGGATTT	ectoderm_lateral_DE_PS1
CATCCACAGGTTCTAC	ectoderm_lateral_NE_PS1
CATCCGTGTGTAGTGG	ectoderm_lateral_DE_PS1
CATGGATTCTCTAGGA	ectoderm_medial_NE_PS1
CATGGTAGTCCTACAA	ectoderm_lateral_NE_PS1
CCACACTAGGCGAACT	ectoderm_medial_NE_PS1
CCCATTGCAGGTGACA	ectoderm_lateral_DE_PS1
CCCGGAATCATGAAAG	ectoderm_medial_NE_PS1
CCCTAACCATTGGATC	ectoderm_intermediate_NE_PS1
CCCTAACTCTCGAACA	ectoderm_medial_NE_PS1
CCCTGATGTGCCTGCA	ectoderm_lateral_NE_PS1
CCGAACGGTTTGTGGT	ectoderm_lateral_NE_PS1
CCGATCTTCTCGGTAA	ectoderm_lateral_NE_PS1
CCGTAGGAGCGGATCA	ectoderm_lateral_NE_PS1
CCTAACCGTATTGGCT	ectoderm_lateral_NE_PS1
CCTCAACAGCGTCTCG	ectoderm_medial_NE_PS1
CCTCCAATCTTGTGCC	ectoderm_intermediate_NE_PS1
CCTCCTCCATTGGATC	ectoderm_lateral_NE_PS1
CCTCTCCAGCACCCAC	ectoderm_lateral_NE_PS1
CCTTGTGGTCTTCAAG	ectoderm_lateral_DE_PS1
CCTTTGGCAGCATACT	ectoderm_medial_NE_PS1
CCTTTGGTCCCGATCT	ectoderm_intermediate_NE_PS1
CGAGAAGAGGTGCTTT	ectoderm_medial_DE_PS1
CGAGAAGCAATGACCT	ectoderm_medial_NE_PS1
CGATGCGGTACGTGAG	ectoderm_medial_DE_PS1
CGCAGGTAGGTTGCCC	ectoderm_lateral_DE_PS1
CGGAATTCAAAGGCAC	ectoderm_lateral_NE_PS1
CGGACACGTCCCTCAT	ectoderm_lateral_NE_PS1
CGGGACTAGGACAGCT	ectoderm_medial_DE_PS1
CGTTCTGCATGACAAA	ectoderm_lateral_DE_PS1
CTAACTTCATGACTCA	ectoderm_medial_DE_PS1
CTAGGTAAGGGCGAGA	ectoderm_lateral_NE_PS1
CTCACTGCAAATGCTC	ectoderm_lateral_NE_PS1
CTCAGTCCACGAGAAC	ectoderm_medial_DE_PS1
CTCCCTCTCGACACCG	ectoderm_intermediate_NE_PS1
CTCTGGTAGGACTTCT	ectoderm_lateral_DE_PS1
CTGCAGGAGAGTCTTC	ectoderm_lateral_DE_PS1
CTGGTCTGTGAGTAGC	ectoderm_medial_NE_PS1
CTGTACCTCAGACATC	ectoderm_medial_DE_PS1
CTTCCTTAGTCCTGTA	ectoderm_lateral_DE_PS1
GAAATGAAGTACCATC	ectoderm_medial_NE_PS1
GAACACTAGTTGCATC	ectoderm_lateral_DE_PS1
GAACTGTGTCCAATCA	ectoderm_medial_DE_PS1
GAAGAATAGAAGCTGC	ectoderm_medial_DE_PS1
GAAGCGACAACCTAAC	ectoderm_intermediate_NE_PS1
GAAGCGATCTACCACC	ectoderm_intermediate_NE_PS1
GAAGGACGTGTGTCGC	ectoderm_medial_DE_PS1
GAAGTAACACAGAGAC	ectoderm_medial_NE_PS1
GACCCTTCAACCGACC	ectoderm_lateral_NE_PS1
GACCGTGAGAGAAGGT	ectoderm_lateral_DE_PS1
GAGACTTCAGTTACCA	ectoderm_medial_NE_PS1
GAGTCATCACTAGTAC	ectoderm_lateral_DE_PS1
GAGTGTTAGGTAGCCA	ectoderm_medial_NE_PS1
GAGTGTTCAGTGACCC	ectoderm_lateral_NE_PS1
GAGTTTGAGCTGCCTG	ectoderm_medial_DE_PS1
GATCACAGTTGTTTGG	ectoderm_lateral_NE_PS1
GATGAGGCATGGGTTT	ectoderm_medial_NE_PS1
GATTCTTCACGTACTA	ectoderm_lateral_DE_PS1
GATTGGTCACAACCGC	ectoderm_medial_NE_PS1
GCACATAGTAGAGACC	ectoderm_intermediate_NE_PS1
GCAGCCATCTAAGCGT	ectoderm_intermediate_NE_PS1
GCAGTTAAGGACTATA	ectoderm_intermediate_NE_PS1
GCATCGGTCCTACTGC	ectoderm_medial_NE_PS1
GCCAACGAGTAATTGG	ectoderm_medial_NE_PS1
GCCAGGTTCGTAGCCG	ectoderm_lateral_NE_PS1
GCCAGGTTCTTCGTGC	ectoderm_medial_NE_PS1
GCCAGTGGTTGCGAAG	ectoderm_lateral_NE_PS1
GCCGTGATCCGCAGTG	ectoderm_medial_NE_PS1
GCGATCGTCGTTAGTG	ectoderm_lateral_DE_PS1
GCGGAAACAACCTATG	ectoderm_intermediate_NE_PS1
GCGGAAATCGTTGTAG	ectoderm_medial_NE_PS1
GCTCAAAAGTTTCGGT	ectoderm_medial_NE_PS1
GCTGCAGGTGGCAACA	ectoderm_medial_NE_PS1
GCTTGGGTCGCAGATT	ectoderm_lateral_NE_PS1
GCTTTCGCAACTCCCT	ectoderm_lateral_NE_PS1
GCTTTCGGTGGCTGCT	ectoderm_lateral_DE_PS1
GGAACCCGTCGGAAAC	ectoderm_medial_NE_PS1
GGCAGTCGTGGGTATG	ectoderm_lateral_DE_PS1
GGCGTCAGTGTTAACC	ectoderm_medial_NE_PS1
GGGACTCTCTCGACCT	ectoderm_medial_DE_PS1
GGGATCCCAGACTGCC	ectoderm_lateral_NE_PS1
GGGCCATCACCTGTCT	ectoderm_lateral_DE_PS1
GGGTTTAAGTCTGGAG	ectoderm_intermediate_NE_PS1
GGTAATCGTCTTGTCC	ectoderm_lateral_DE_PS1
GGTAGAGAGAGTTGTA	ectoderm_medial_DE_PS1
GGTGATTGTTCCAAAC	ectoderm_lateral_DE_PS1
GGTGATTTCCCAATAG	ectoderm_intermediate_NE_PS1
GGTGTCGAGCATGGGT	ectoderm_medial_NE_PS1
GTACAACAGCCGATCC	ectoderm_medial_DE_PS1
GTAGATCTCCCGAGAC	ectoderm_medial_NE_PS1
GTAGCTATCACCATCC	ectoderm_intermediate_NE_PS1
GTAGGAGCAGTTAAAG	ectoderm_lateral_DE_PS1
GTAGGAGCATACAGAA	ectoderm_medial_NE_PS1
GTAGTACAGCAGCGAT	ectoderm_lateral_NE_PS1
GTCAAACTCATCACTT	ectoderm_lateral_DE_PS1
GTCCCATGTTAGGGTG	ectoderm_lateral_DE_PS1
GTCGAATCAATCGCAT	ectoderm_lateral_DE_PS1
GTCTACCTCGACCAAT	ectoderm_intermediate_NE_PS1
GTCTCACGTGCCCAGT	ectoderm_lateral_NE_PS1
GTGAGGAAGCAAACAT	ectoderm_medial_NE_PS1
GTGCTGGTCAGTCAGT	ectoderm_medial_NE_PS1
GTGCTTCAGCTAAACA	ectoderm_medial_NE_PS1
GTGCTTCAGGTTACCT	ectoderm_lateral_DE_PS1
GTGCTTCGTATCCTTT	ectoderm_medial_NE_PS1
GTGGAGACAGCGCTTG	ectoderm_intermediate_NE_PS1
GTGGGAACAATCGAAA	ectoderm_medial_DE_PS1
GTTACAGAGGTTGACG	ectoderm_lateral_DE_PS1
GTTAGACTCCTACTGC	ectoderm_medial_NE_PS1
GTTCGCTTCTCCGCAT	ectoderm_medial_NE_PS1
GTTCTATCATTGGCAT	ectoderm_medial_DE_PS1
GTTGCGGAGCAATAGT	ectoderm_lateral_DE_PS1
TAACCAGGTCATCGGC	ectoderm_lateral_NE_PS1
TAACGACAGGTCTTTG	ectoderm_medial_NE_PS1
TAAGCCAGTAATACCC	ectoderm_lateral_DE_PS1
TACGGTAAGGGTTGCA	ectoderm_lateral_NE_PS1
TACTGCCGTAGGATAT	ectoderm_medial_NE_PS1
TACTGCCTCATTTGGG	ectoderm_lateral_NE_PS1
TAGATCGGTTGGTAGG	ectoderm_medial_NE_PS1
TAGGTACGTCCTGGGT	ectoderm_intermediate_NE_PS1
TATCTGTTCCAGCCTT	ectoderm_medial_DE_PS1
TATTGCTAGGGCAGAG	ectoderm_lateral_DE_PS1
TCAAGTGTCGTCCTCA	ectoderm_lateral_DE_PS1
TCACGGGAGTAACGTA	ectoderm_lateral_NE_PS1
TCATATCCAGCTCCTT	ectoderm_intermediate_NE_PS1
TCATGAGTCTCCTGCA	ectoderm_intermediate_NE_PS1
TCATGCCAGGACGCAT	ectoderm_medial_DE_PS1
TCATGCCCATGTCAGT	ectoderm_lateral_DE_PS1
TCATTTGGTCGAGCTC	ectoderm_intermediate_NE_PS1
TCCAGAACATTGAGGG	ectoderm_lateral_DE_PS1
TCCCAGTGTTACGGAG	ectoderm_lateral_NE_PS1
TCCGATCTCACCTCGT	ectoderm_intermediate_NE_PS1
TCCTCGAGTTCCGGTG	ectoderm_lateral_DE_PS1
TCGAAGTCAAGATGTA	ectoderm_medial_NE_PS1
TCGGGCATCGCTAAAC	ectoderm_intermediate_NE_PS1
TCTAACTAGGCTGGAT	ectoderm_intermediate_NE_PS1
TCTACCGCAGCCTTCT	ectoderm_lateral_DE_PS1
TCTCAGCAGTGCACAG	ectoderm_medial_DE_PS1
TCTGTCGCATAACCCA	ectoderm_lateral_NE_PS1
TCTTGCGGTGGTCTTA	ectoderm_medial_NE_PS1
TGAGGTTCAACCGTGC	ectoderm_medial_NE_PS1
TGCGATAGTGAGACCA	ectoderm_lateral_NE_PS1
TGCTCCAGTCTACACA	ectoderm_intermediate_NE_PS1
TGCTCGTTCCGAAGGA	ectoderm_lateral_DE_PS1
TGGATGTCATTGCCTC	ectoderm_lateral_DE_PS1
TGTAACGAGGACAGCT	ectoderm_lateral_NE_PS1
TGTTCATAGAGTATAC	ectoderm_lateral_NE_PS1
TTACCATGTACTCGAT	ectoderm_medial_NE_PS1
TTCCTTCGTTGCCGCA	ectoderm_lateral_NE_PS1
TTGAGTGAGAAGCGAA	ectoderm_lateral_NE_PS1
TTGCATTAGTCATCGT	ectoderm_medial_NE_PS1
TTGCCTGTCTGAACGT	ectoderm_intermediate_NE_PS1
TTGTGGACATGACGTT	ectoderm_medial_DE_PS1
TTGTTCAGTCACGTGC	ectoderm_intermediate_NE_PS1
TTTACTGCAAGCTGTT	ectoderm_lateral_NE_PS1
TTTATGCCACACGTGC	ectoderm_medial_NE_PS1
TTTCAGTTCATCAGTG	ectoderm_lateral_NE_PS1
TTTCGATCAGGAATCG	ectoderm_lateral_NE_PS1
TTTCGATGTAGTGTGG	ectoderm_medial_NE_PS1
TTTGACTAGCACTCGC	ectoderm_lateral_NE_PS1
