manual_ID
AAACCCAGTCATAGTC	amnioserosa_PS2
AAAGAACTCTCCTGCA	ectoderm_head_Optix_Six4
AAAGTGAAGAGAAGGT	ectoderm_head_oc_Oaz
AACAAAGAGATCACCT	ectoderm_head_oc_Doc2
AACAAAGGTACGTGTT	ectoderm_intermediate_NE_PS0
AACACACTCAGCGCAC	ectoderm_head_oc_CenG1A
AACCAACGTAAGCGGT	ectoderm_medial_NE_PS0
AACCACATCCTTACCG	ectoderm_head_kn_lateral
AACCTGACATTGAGCT	ectoderm_head_croc
AAGGTAACACTTACAG	ectoderm_head_oc_Doc2
AAGGTAACATTGACTG	ectoderm_head_kn_lateral
AAGGTAAGTGTCGCTG	amnioserosa_PS2
AAGTGAAGTCGCAGTC	ectoderm_head_oc_Pvf3_lateral
AATCGACAGCTAGTTC	ectoderm_head_oc_Oaz
AATGAAGTCACCGGGT	ectoderm_head_croc
AATGCCATCAGGAACG	ectoderm_DE_PS0
AATGGAAGTTGTAAAG	amnioserosa_PS3
ACAACCAAGGCCTAAG	ectoderm_head_oc_so
ACAACCACATTGGATC	ectoderm_head_oc_Pvf3_medial
ACAAGCTCACAAGGTG	amnioserosa_PS1
ACAAGCTTCCGGCAGT	ectoderm_medial_NE_PS0
ACACGCGAGTTAGTAG	ectoderm_head_oc_CenG1A
ACAGGGAAGCCTATCA	ectoderm_head_oc_Pvf3_medial
ACAGGGACAACGGCCT	ectoderm_head_croc
ACCATTTTCGTGCAGC	ectoderm_DE_PS0
ACCCTCATCTAAGCGT	ectoderm_lateral_NE_PS0
ACCTACCCATCCGGCA	ectoderm_DE_PS0
ACCTGAATCTTACGTT	amnioserosa_PS1
ACCTGTCAGCCTCACG	ectoderm_head_oc_so
ACCTGTCCAGAGGAAA	ectoderm_medial_NE_PS0
ACGATCAAGGAACGCT	ectoderm_head_croc
ACGCACGGTAGATGTA	amnioserosa_PS2
ACGTCCTGTCGAAACG	ectoderm_head_oc_Pvf3_medial
ACGTCCTTCCGTAGTA	ectoderm_head_croc
ACGTTCCTCTGCGGGT	ectoderm_head_oc_Pvf3_medial
ACTATTCTCTCCGATC	ectoderm_medial_NE_PS0
ACTCCCAGTCCTGGGT	ectoderm_head_oc_so
ACTGCAAAGCACCTGC	ectoderm_head_croc
ACTTTCAGTGAATAAC	amnioserosa_PS2
AGACACTGTGATACAA	ectoderm_head_kn_lateral
AGACCCGTCTGCGATA	ectoderm_head_oc_so
AGAGAATGTACGAGCA	ectoderm_head_oc_Doc2
AGAGAATTCGCTTGAA	ectoderm_lateral_NE_PS0
AGATAGAAGGGTACAC	ectoderm_head_kn_medial
AGATCCAGTTGCGGCT	ectoderm_head_kn_lateral
AGATGAATCTCGCAGG	ectoderm_head_croc
AGATGCTAGGTCTACT	ectoderm_head_Optix_Six4
AGCCAATTCCGCACTT	ectoderm_head_oc_CenG1A
AGCCACGTCACCTCTG	ectoderm_head_oc_Doc2
AGGACGAGTGATGGCA	ectoderm_head_oc_Doc2
AGGAGGTGTTGTGTAC	ectoderm_intermediate_NE_PS0
AGGATAAAGAAACCCG	ectoderm_head_kn_medial
AGGATAAAGGGTGGGA	ectoderm_head_kn_medial
AGGCATTGTAGATTGA	ectoderm_head_oc_Oaz
AGGCTGCGTGACAGGT	ectoderm_intermediate_NE_PS0
AGGGTCCGTGCGACAA	ectoderm_head_oc_so
AGGTTACAGGTATTGA	amnioserosa_PS2
AGTAACCAGGGCAATC	ectoderm_medial_NE_PS0
AGTACTGGTCACGACC	ectoderm_head_oc_Oaz
AGTCACACAGAAACCG	ectoderm_head_oc_so
AGTGCCGCAACTCGAT	ectoderm_head_kn_lateral
ATACTTCAGACTTAAG	ectoderm_head_oc_Pvf3_medial
ATACTTCCAGAGAAAG	amnioserosa_PS1
ATAGACCTCCCTGGTT	ectoderm_head_kn_lateral
ATCACGAAGTTGCGCC	ectoderm_lateral_NE_PS0
ATCACGACAGTAGTGG	ectoderm_DE_PS0
ATCACTTAGACATAAC	ectoderm_head_Optix_sog
ATCACTTGTGCGTGCT	ectoderm_head_kn_lateral
ATCATTCGTGTGTGTT	ectoderm_head_oc_Pvf3_medial
ATCCCTGGTCTAACTG	ectoderm_medial_NE_PS0
ATCCGTCTCCATCTGC	amnioserosa_PS2
ATCGATGAGTTTCAGC	ectoderm_head_Optix_Six4
ATCGGATCAATACAGA	ectoderm_head_oc_CenG1A
ATCTCTACAGCTGTCG	amnioserosa_PS1
ATCTTCACACTTGTGA	ectoderm_head_oc_Pvf3_medial
ATGACCAGTTTACGTG	amnioserosa_PS2
ATGAGGGGTGATTAGA	ectoderm_head_Optix_Six4
ATGCCTCGTGGTCTGC	ectoderm_head_croc
ATGGATCCATTGCAAC	ectoderm_head_oc_Doc2
ATTACCTCAATGGGTG	ectoderm_intermediate_NE_PS0
ATTCACTGTCTCGACG	ectoderm_head_kn_lateral
ATTCACTTCTAGAACC	amnioserosa_PS2
ATTCAGGGTGCGTTTA	ectoderm_lateral_NE_PS0
ATTCCATCAAGCGAAC	ectoderm_DE_PS0
ATTCCATGTGTTTCTT	ectoderm_head_oc_Pvf3_medial
ATTCGTTGTCCCGGTA	ectoderm_head_oc_CenG1A
ATTCGTTGTCTGTAAC	ectoderm_head_oc_Pvf3_medial
ATTCTTGCAAGTTCGT	ectoderm_head_oc_Pvf3_medial
ATTGGGTGTGACGCCT	amnioserosa_PS3
CAACAGTGTATCGGTT	ectoderm_head_Optix_Six4
CAACCAAGTCTACATG	ectoderm_intermediate_NE_PS0
CAACGGCAGGATTTGA	amnioserosa_PS2
CAAGACTGTTCTAAGC	ectoderm_head_oc_Oaz
CAATGACAGATTGCGG	ectoderm_DE_PS0
CACAACATCGAGCCTG	ectoderm_head_croc
CACACAAAGCCTCCAG	amnioserosa_PS3
CACACAATCCTTATGT	amnioserosa_PS1
CACGAATCATAACTCG	ectoderm_head_kn_medial
CACGTTCAGAAGCTGC	ectoderm_head_oc_Pvf3_lateral
CACTAAGTCGTTGTTT	amnioserosa_PS3
CACTAAGTCTTACCAT	ectoderm_head_kn_lateral
CACTGTCGTTCTGACA	ectoderm_head_kn_lateral
CAGCAATAGGATGAGA	ectoderm_head_Optix_sog
CAGCAATGTTGCCATA	ectoderm_head_Optix_Six4
CAGCACGAGCAGAAAG	ectoderm_head_kn_medial
CAGCACGAGTTACGGG	ectoderm_head_Optix_Six4
CAGCAGCAGTCATGGG	ectoderm_lateral_NE_PS0
CAGCAGCCACGCGTGT	ectoderm_head_Optix_Six4
CAGCAGCGTGTCCACG	ectoderm_head_oc_Oaz
CAGCCAGTCAGACCCG	ectoderm_head_Optix_Six4
CATAAGCAGAGCAGCT	ectoderm_head_kn_medial
CATACCCTCGTAACTG	ectoderm_head_oc_Pvf3_medial
CATCGGGGTCCCTGAG	ectoderm_head_oc_so
CATTCTACACAAGTGG	ectoderm_head_oc_CenG1A
CATTCTACAGCAAGAC	ectoderm_head_oc_CenG1A
CATTGTTAGCAAACAT	ectoderm_head_oc_CenG1A
CATTTCACAAGATGTA	ectoderm_lateral_NE_PS0
CCAATGAAGCGACCCT	ectoderm_head_croc
CCAATTTAGACGTCGA	ectoderm_intermediate_NE_PS0
CCACGAGTCAGGAAAT	ectoderm_intermediate_NE_PS0
CCATCACAGGCTCAAG	amnioserosa_PS3
CCATCACCAATAGTGA	ectoderm_head_oc_Oaz
CCCGAAGTCGGACTTA	ectoderm_head_Optix_sog
CCCGAAGTCTGGGAGA	ectoderm_lateral_NE_PS0
CCCTCAACAAAGACTA	ectoderm_intermediate_NE_PS0
CCCTCTCTCCTAAACG	ectoderm_head_kn_lateral
CCGATGGCAACACAGG	ectoderm_lateral_NE_PS0
CCGATGGCAGAAGCGT	ectoderm_head_kn_medial
CCGCAAGAGACCCTTA	ectoderm_head_oc_CenG1A
CCGGACACACTCTAGA	ectoderm_head_Optix_sog
CCGTGAGGTGTTGAGG	ectoderm_medial_NE_PS0
CCGTTCACATTGAAAG	ectoderm_medial_NE_PS0
CCTAACCTCTTCTTCC	ectoderm_medial_NE_PS0
CCTAAGAGTTGTTGCA	ectoderm_medial_NE_PS0
CCTCACATCCTTCGAC	ectoderm_head_oc_Pvf3_lateral
CCTCAGTTCCCATTTA	ectoderm_head_Optix_sog
CCTCAGTTCTTTCTAG	ectoderm_head_oc_so
CCTCTAGGTCCAAGAG	amnioserosa_PS3
CCTCTCCTCCGATCTC	ectoderm_head_oc_CenG1A
CCTGCATCACCAAATC	ectoderm_head_oc_Pvf3_lateral
CCTTTGGGTACCAGAG	ectoderm_DE_PS0
CGAAGGAGTCCCTCAT	ectoderm_intermediate_NE_PS0
CGATGCGCAGTGTATC	ectoderm_head_Optix_Six4
CGCAGGTAGCAAGGAA	ectoderm_head_Optix_Six4
CGCCATTAGAGAGCAA	ectoderm_head_oc_Pvf3_medial
CGCCATTCATTCCTAT	ectoderm_head_oc_Pvf3_medial
CGGTCAGTCTAGACCA	ectoderm_head_kn_medial
CGTCCATTCCGTGTGG	ectoderm_head_Optix_sog
CGTTAGACAAGAGTGC	ectoderm_head_oc_CenG1A
CTAACTTAGTAACCGG	ectoderm_head_kn_medial
CTACATTTCTAGCCTC	amnioserosa_PS3
CTACCCAAGAGATGCC	ectoderm_DE_PS0
CTACTATAGGTAGATT	ectoderm_head_oc_Pvf3_medial
CTAGGTACATCACAGT	ectoderm_head_croc
CTAGGTAGTCCATAGT	ectoderm_intermediate_NE_PS0
CTATAGGCACAAATAG	ectoderm_head_oc_so
CTCACTGAGAGCAACC	ectoderm_head_kn_lateral
CTCACTGTCTACTATC	ectoderm_head_oc_Pvf3_medial
CTCAGTCGTTGTGCCG	ectoderm_head_kn_lateral
CTCATCGGTAGGTCAG	ectoderm_head_croc
CTCCAACAGCTAGAAT	ectoderm_head_Optix_Six4
CTCCATGAGAGCATTA	ectoderm_medial_NE_PS0
CTCCCTCAGTGCAGGT	ectoderm_head_oc_so
CTCGAGGAGTAGCAAT	ectoderm_DE_PS0
CTCTCAGTCCGGGACT	ectoderm_head_oc_CenG1A
CTCTCGACAAATAAGC	ectoderm_lateral_NE_PS0
CTCTGGTGTCGGAAAC	ectoderm_head_oc_Oaz
CTCTGGTGTCGGTACC	ectoderm_head_oc_CenG1A
CTGATCCAGGGAGTGG	ectoderm_head_oc_Oaz
CTGCATCGTGCGAGTA	ectoderm_head_oc_so
CTGCATCTCACGACTA	ectoderm_head_oc_so
CTGCCATTCGTGGACC	ectoderm_head_oc_so
CTGCCTAAGACTTCCA	ectoderm_medial_NE_PS0
CTGCGAGAGAAGCGGG	ectoderm_head_kn_lateral
CTGGCAGGTGTATTCG	ectoderm_head_oc_Oaz
CTGGCAGTCTCGTTTA	ectoderm_head_Optix_sog
CTGTAGATCAAGATAG	ectoderm_head_Optix_Six4
CTGTCGTAGATGAACT	ectoderm_lateral_NE_PS0
CTGTGAAGTTGGAGAC	ectoderm_head_oc_Doc2
CTGTGAATCTTGCAGA	ectoderm_lateral_NE_PS0
CTGTGGGCATGAAGCG	ectoderm_head_kn_medial
CTTACCGAGTGGATAT	ectoderm_head_Optix_sog
CTTTCGGTCATGGCCG	ectoderm_head_Optix_sog
GAACGTTAGTTGCTCA	ectoderm_head_oc_Pvf3_medial
GAACGTTTCTGCGGAC	ectoderm_head_oc_Pvf3_lateral
GAATCACCAGCGACAA	ectoderm_medial_NE_PS0
GAATCGTCACACTGGC	ectoderm_intermediate_NE_PS0
GACACGCCAGACACAG	ectoderm_DE_PS0
GACACGCCAGACGATG	ectoderm_head_croc
GACACGCGTGCAACGA	ectoderm_head_oc_CenG1A
GACATCACATTGACCA	amnioserosa_PS1
GACATCATCATCTCTA	ectoderm_lateral_NE_PS0
GACCAATAGTTGGCTT	ectoderm_medial_NE_PS0
GACCAATGTACTAACC	ectoderm_DE_PS0
GACCGTGCACGATAGG	amnioserosa_PS3
GACTGATTCACTTATC	amnioserosa_PS2
GAGAAATAGGTACAAT	ectoderm_intermediate_NE_PS0
GAGCCTGAGTTAGTGA	amnioserosa_PS3
GAGGGTAAGTCTACCA	ectoderm_head_croc
GAGGGTATCCTCTAAT	ectoderm_head_oc_Oaz
GAGTCATGTGCGTGCT	ectoderm_head_oc_Pvf3_medial
GAGTTACCATCTTAGG	ectoderm_medial_NE_PS0
GAGTTTGGTCCAGAAG	ectoderm_head_kn_lateral
GATAGAACAGTAACGG	ectoderm_lateral_NE_PS0
GATAGCTGTCCGATCG	ectoderm_medial_NE_PS0
GATCACACAAGTGATA	ectoderm_medial_NE_PS0
GATCCCTAGCTGACAG	ectoderm_head_kn_lateral
GATCGTAGTTCCACAA	amnioserosa_PS2
GATGACTTCTTTCCGG	ectoderm_head_Optix_sog
GATGGAGCATGTGGTT	ectoderm_head_Optix_sog
GATTTCTGTCCTGAAT	amnioserosa_PS3
GCAACCGTCGGACCAC	ectoderm_head_oc_so
GCACGGTTCCCGTGTT	ectoderm_head_oc_CenG1A
GCAGTTATCTGTCAGA	ectoderm_head_croc
GCATCTCAGGTAAAGG	ectoderm_head_oc_Pvf3_medial
GCCAGGTGTGTCATCA	ectoderm_lateral_NE_PS0
GCCATGGTCTTGTGCC	ectoderm_head_Optix_sog
GCCGATGCATAGACTC	ectoderm_head_kn_lateral
GCGGAAACAGATCACT	ectoderm_head_croc
GCGTTTCAGTTTCGGT	ectoderm_head_oc_Doc2
GCTACAATCGCTGCGA	amnioserosa_PS1
GCTACCTAGCAAGGAA	ectoderm_head_Optix_Six4
GCTTCACGTTGCCGAC	ectoderm_head_Optix_sog
GCTTGGGGTGGATACG	amnioserosa_PS3
GCTTGGGTCGACGCGT	ectoderm_head_oc_so
GCTTTCGCAGACCGCT	ectoderm_head_croc
GGAATCTTCCTTCTAA	ectoderm_head_Optix_Six4
GGAGATGAGAGTCAGC	ectoderm_head_oc_Doc2
GGATCTAGTGGGTCAA	ectoderm_head_croc
GGGACAACACCCTCTA	amnioserosa_PS3
GGGATCCTCGGAACTT	ectoderm_head_oc_Pvf3_lateral
GGGATCCTCGTACCTC	ectoderm_head_oc_CenG1A
GGGATGAGTCGCACGT	ectoderm_head_oc_Pvf3_medial
GGGTATTAGAAACTAC	ectoderm_head_oc_so
GGGTCACTCATGAGAA	ectoderm_head_oc_Pvf3_medial
GGGTGTCTCAGACTGT	ectoderm_DE_PS0
GGGTTATCATTGTAGC	ectoderm_intermediate_NE_PS0
GGTAATCTCCGTATAG	amnioserosa_PS1
GTAACCAAGCACGTCC	ectoderm_head_oc_Oaz
GTAATCGGTACTGTTG	ectoderm_head_oc_Pvf3_medial
GTAATGCAGCGTGTTT	ectoderm_head_Optix_Six4
GTACAACTCCAAGGGA	ectoderm_head_oc_so
GTAGAGGTCCGTCAAA	amnioserosa_PS3
GTAGGTTCACTAACCA	ectoderm_head_Optix_sog
GTAGTACGTCTGTCCT	ectoderm_head_oc_CenG1A
GTATTGGTCCGTTGGG	ectoderm_head_kn_lateral
GTATTTCTCACTTATC	ectoderm_head_Optix_Six4
GTCATCCTCGTCGACG	ectoderm_head_kn_lateral
GTCATGAAGGTCGTAG	ectoderm_head_oc_Oaz
GTCATGACATCCTAAG	ectoderm_head_kn_lateral
GTCCACTCATGTCTAG	ectoderm_head_oc_CenG1A
GTCGAATCAAGTGGAC	amnioserosa_PS3
GTCGAATTCTATCACT	amnioserosa_PS1
GTCGTAATCCGTAATG	amnioserosa_PS1
GTCTAGAGTTTCACAG	amnioserosa_PS2
GTCTGTCAGCTGCGAA	ectoderm_DE_PS0
GTGACGCCACTACTTT	ectoderm_head_oc_Doc2
GTGAGGAAGTTAGAAC	ectoderm_head_kn_medial
GTGAGGAGTTACACTG	ectoderm_DE_PS0
GTGCACGCATCTAACG	ectoderm_head_croc
GTGGCGTCAGAACTCT	ectoderm_head_kn_lateral
GTGTAACGTTAGGGAC	ectoderm_lateral_NE_PS0
GTGTCCTAGTAGTCAA	ectoderm_head_oc_CenG1A
GTGTGATCACTAGAGG	ectoderm_head_oc_CenG1A
GTGTTAGTCGTGGTAT	ectoderm_head_kn_medial
GTTAGACAGAGCCATG	ectoderm_head_oc_Oaz
GTTCGCTAGGTTCATC	ectoderm_head_Optix_Six4
GTTCGCTGTGTCCGGT	ectoderm_head_oc_so
GTTGCTCGTGGTCTCG	ectoderm_head_croc
GTTGCTCTCCTTCAGC	amnioserosa_PS1
GTTGTAGGTCTGTAGT	ectoderm_lateral_NE_PS0
GTTTACTTCAGACCGC	ectoderm_head_kn_medial
TAACACGCATATCTGG	ectoderm_head_oc_so
TAAGCACCACCCAAGC	ectoderm_head_Optix_sog
TAAGCACGTACAGTTC	ectoderm_head_oc_CenG1A
TAAGTCGGTTCGCGTG	ectoderm_head_Optix_sog
TAATCTCGTTCTTAGG	ectoderm_lateral_NE_PS0
TACACCCTCAGGACAG	ectoderm_lateral_NE_PS0
TACAGGTAGCGCCTAC	ectoderm_head_oc_Pvf3_lateral
TACATTCTCCGCGGAT	ectoderm_intermediate_NE_PS0
TACATTCTCTATCACT	ectoderm_head_Optix_Six4
TACGCTCCAATCGCAT	ectoderm_head_Optix_Six4
TACGTCCAGTTTGCTG	ectoderm_head_Optix_Six4
TACGTCCTCCGGCTTT	ectoderm_medial_NE_PS0
TACTGCCGTTCTTGTT	ectoderm_head_oc_CenG1A
TACTTACGTCTACATG	amnioserosa_PS1
TACTTCAAGTAACGAT	ectoderm_head_croc
TAGACCATCGGTCAGC	amnioserosa_PS1
TAGACTGAGCGCCGTT	amnioserosa_PS3
TAGACTGGTTGCATCA	ectoderm_DE_PS0
TAGATCGCACGTACAT	ectoderm_intermediate_NE_PS0
TAGGGTTAGGCATTTC	ectoderm_lateral_NE_PS0
TAGGTACCAATAACCC	amnioserosa_PS2
TATCAGGCATAGCACT	ectoderm_head_oc_Doc2
TATCTGTAGGTGCTGA	ectoderm_medial_NE_PS0
TATCTGTCACGCAAAG	amnioserosa_PS1
TATGTTCTCGCGTTTC	amnioserosa_PS1
TCAAGCAAGGTGCTTT	ectoderm_head_oc_Pvf3_medial
TCAAGTGGTGTAGTGG	ectoderm_head_croc
TCAATCTTCTGTACAG	ectoderm_head_oc_Oaz
TCACGCTCAATAAGGT	ectoderm_head_croc
TCACGCTGTAATTGGA	ectoderm_lateral_NE_PS0
TCACGCTTCGCTTAAG	ectoderm_intermediate_NE_PS0
TCACGGGGTTCAACGT	ectoderm_head_oc_CenG1A
TCATCATGTTCGGTAT	ectoderm_head_Optix_Six4
TCATGAGTCTCGGTCT	ectoderm_DE_PS0
TCATTACTCGCTATTT	ectoderm_head_kn_lateral
TCATTCACACTGCTTC	ectoderm_head_croc
TCATTTGGTATGCTAC	ectoderm_head_oc_Doc2
TCCACCAAGTTGCCTA	ectoderm_head_croc
TCCACCATCACTCGAA	ectoderm_medial_NE_PS0
TCCACGTCAGCTGAGA	ectoderm_head_kn_lateral
TCCACGTTCGGCCCAA	ectoderm_head_Optix_Six4
TCCAGAACAGAACGCA	ectoderm_medial_NE_PS0
TCCATCGAGATAGCTA	ectoderm_medial_NE_PS0
TCCATCGAGCAGGCAT	ectoderm_medial_NE_PS0
TCCCAGTAGACAGCGT	ectoderm_head_Optix_sog
TCCGAAAAGGCTCACC	ectoderm_head_kn_medial
TCCGGGACAAACTGCT	ectoderm_head_kn_medial
TCCGTGTGTAACCCGC	ectoderm_head_Optix_sog
TCCTTCTAGGAGGCAG	ectoderm_lateral_NE_PS0
TCGACGGCACAGAAGC	ectoderm_medial_NE_PS0
TCGATTTGTCAGACGA	ectoderm_medial_NE_PS0
TCGCACTTCTGTTGGA	ectoderm_head_croc
TCGGATATCTAGATCG	ectoderm_head_kn_medial
TCTACATAGAGTACCG	amnioserosa_PS2
TCTATCAGTCACTGAT	amnioserosa_PS2
TCTCCGAGTGTGTCGC	ectoderm_head_oc_CenG1A
TCTGCCAGTCACTTAG	ectoderm_head_oc_CenG1A
TCTGCCAGTGGTCTGC	ectoderm_medial_NE_PS0
TCTGTCGTCATACGGT	ectoderm_head_Optix_sog
TCTTCCTAGACTTGTC	ectoderm_medial_NE_PS0
TCTTCCTCAATCCAGT	ectoderm_head_oc_so
TCTTTGAAGATGGGCT	ectoderm_head_Optix_sog
TGAATCGTCTCGACCT	ectoderm_intermediate_NE_PS0
TGACTCCTCTCAGAAC	ectoderm_head_oc_Pvf3_lateral
TGAGACTAGCGATCGA	ectoderm_head_oc_CenG1A
TGAGCATGTCCTCAGG	ectoderm_head_kn_medial
TGAGCATTCCAGTGTA	ectoderm_head_croc
TGAGGAGTCTGTCCGT	ectoderm_head_croc
TGAGGTTAGATGCTGG	ectoderm_head_oc_CenG1A
TGATGCAAGAGACAAG	ectoderm_head_Optix_sog
TGCAGATCAAACAGGC	ectoderm_head_kn_medial
TGCATGACATCGTGCG	ectoderm_head_kn_medial
TGCATGAGTTATCCAG	ectoderm_head_kn_lateral
TGCCGAGAGCTGACCC	ectoderm_head_croc
TGCGACGGTATCATGC	ectoderm_head_oc_so
TGCGGGTGTATACAGA	amnioserosa_PS2
TGCTGAATCTCACGAA	ectoderm_medial_NE_PS0
TGCTTGCCATCGTGGC	amnioserosa_PS2
TGGCGTGCACAATGCT	ectoderm_medial_NE_PS0
TGGCGTGTCGATAACC	ectoderm_intermediate_NE_PS0
TGGGAAGCAGCGATTT	ectoderm_medial_NE_PS0
TGGGTTAGTTTCCCAC	ectoderm_head_oc_CenG1A
TGGTAGTGTAGTCACT	ectoderm_head_croc
TGGTAGTGTTCCTTGC	ectoderm_head_Optix_Six4
TGGTGATAGCGTGAGT	amnioserosa_PS1
TGTAAGCGTGTTCGTA	ectoderm_head_kn_medial
TGTACAGTCTGGGTCG	amnioserosa_PS2
TGTCCACAGCACACAG	ectoderm_head_oc_Oaz
TGTCCACGTAGATTAG	ectoderm_intermediate_NE_PS0
TGTCCACGTGTAGGAC	ectoderm_head_kn_medial
TGTCCTGTCTTGGTGA	ectoderm_head_oc_CenG1A
TGTGATGCAGAGTGAC	ectoderm_DE_PS0
TGTGCGGGTTTGCCGG	ectoderm_head_oc_so
TGTTCTACATAAGCGG	ectoderm_head_oc_Pvf3_medial
TGTTTGTAGCGTATAA	ectoderm_head_oc_CenG1A
TTACCATTCTCTGGTC	ectoderm_head_Optix_Six4
TTCCGGTCAATTGGTC	ectoderm_medial_NE_PS0
TTCGATTTCATGGAGG	ectoderm_head_croc
TTCGCTGAGCCTCAGC	ectoderm_head_oc_Pvf3_medial
TTCGCTGTCCGTCACT	ectoderm_head_kn_medial
TTCGGTCTCAGTGGGA	ectoderm_DE_PS0
TTCTAACGTCATCGCG	ectoderm_head_croc
TTCTCTCGTTCTCCAC	ectoderm_head_kn_medial
TTCTGTACATAATCGC	ectoderm_DE_PS0
TTCTTCCAGGAACGCT	amnioserosa_PS3
TTGCTGCGTTCCGCTT	ectoderm_head_oc_CenG1A
TTGGGATTCGAAGCAG	ectoderm_head_kn_medial
TTGGGCGGTCACCCTT	ectoderm_head_oc_so
TTGGTTTCACAGAGAC	ectoderm_head_kn_lateral
TTGGTTTTCCTCGATC	ectoderm_lateral_NE_PS0
TTGTGTTTCCACGTGG	amnioserosa_PS2
TTTACCATCAAATGAG	ectoderm_DE_PS0
TTTACGTCAGTGTGCC	ectoderm_head_Optix_sog
TTTACTGTCAGCATTG	ectoderm_lateral_NE_PS0
TTTAGTCGTCCACTCT	amnioserosa_PS1
TTTCAGTCATGGGATG	amnioserosa_PS2
TTTCAGTTCTCAATCT	ectoderm_head_oc_Pvf3_medial
TTTCATGGTGGGCTCT	ectoderm_head_oc_so
TTTCCTCTCAAGCCAT	amnioserosa_PS2
TTTCGATGTAACAGGC	ectoderm_head_Optix_Six4
TTTGATCTCTTCTGTA	amnioserosa_PS2
TTTGGAGCATTGAAGA	ectoderm_head_oc_so
TTTGGTTCAGGGAGAG	ectoderm_head_Optix_Six4
