manual_ID
AAAGGATCACTTGAAC	mesoderm_PS1_Dfd
AAGCATCAGCTAAATG	mesoderm_PS1_Dfd
AAGGAATGTACTGGGA	mesoderm_PS2_ken
AATAGAGCAAGTATAG	mesoderm_PS2_ken
AATCACGCAGGTACGA	mesoderm_PS2_ken
AATCGACCACCTGTCT	mesoderm_PS2_ken
ACAAGCTTCCAGCCTT	mesoderm_PS2_ken
ACAGGGACACCGTGGT	mesoderm_PS2_ken
ACATGCAGTACACTCA	mesoderm_PS2_ken
ACATTTCAGTTCAACC	mesoderm_PS1_Dfd
ACCAAACTCAGTCACA	mesoderm_PS1_Dfd
ACCCTTGGTTGACTAC	mesoderm_PS2_ken
ACTTTGTAGATGTTGA	mesoderm_PS2_ken
AGAACAAGTCGTGATT	mesoderm_PS2_ken
AGAAGTAGTCATCCCT	mesoderm_PS1_Dfd
AGCGCCATCATGGGAG	mesoderm_PS1_Dfd
AGCTTCCCACCGCTAG	mesoderm_PS1_Dfd
AGCTTCCCACGAAGAC	mesoderm_PS1_Dfd
AGGAGGTCAAGGGTCA	mesoderm_PS1_Dfd
AGGATCTTCGAAGAAT	mesoderm_PS1_Dfd
AGTCAACTCATTGCTT	mesoderm_PS1_Dfd
AGTCACATCCTCTCTT	mesoderm_PS2_ken
AGTGACTAGGCATGCA	mesoderm_PS2_ken
ATAGAGAAGAACTCCT	mesoderm_PS1_Dfd
ATCACGACATAATGAG	mesoderm_PS1_Dfd
ATCATTCTCAAGCCTA	mesoderm_PS1_Dfd
ATCCGTCCAGTATGAA	mesoderm_PS2_ken
ATCCTATTCACTTATC	mesoderm_PS1_Dfd
ATGGAGGAGTAAGAGG	mesoderm_PS1_Dfd
ATGGATCAGGTAGGCT	mesoderm_PS2_ken
ATTGGGTCAGACCAGA	mesoderm_PS2_ken
ATTTCACTCCCAGTGG	mesoderm_PS2_ken
CAAAGAACACAATGTC	mesoderm_PS1_Dfd
CAACGATAGGAGATAG	mesoderm_PS2_ken
CACAGGCCAACGGTAG	mesoderm_PS2_ken
CACAGGCCATCGATCA	mesoderm_PS2_ken
CAGAGCCTCAATCAGC	mesoderm_PS2_ken
CAGCGTGTCTCTGGTC	mesoderm_PS2_ken
CAGGGCTAGTACTCGT	mesoderm_PS2_ken
CATACCCTCTCTCGAC	mesoderm_PS2_ken
CATCCCAAGAAGCCAC	mesoderm_PS2_ken
CATCGTCAGCATGTTC	mesoderm_PS2_ken
CATCGTCAGGTTCCAT	mesoderm_PS2_ken
CCACAAACACTGGAAG	mesoderm_PS1_Dfd
CCCTGATTCCGCCTAT	mesoderm_PS2_ken
CCGAACGCAGTCGGAA	mesoderm_PS2_ken
CCGAACGTCTTAGTTC	mesoderm_PS1_Dfd
CCGCAAGTCCACGGGT	mesoderm_PS1_Dfd
CCTAACCGTAAGTAGT	mesoderm_PS1_Dfd
CCTAAGACATTCGATG	mesoderm_PS1_Dfd
CCTGTTGTCTTCCCAG	mesoderm_PS2_ken
CGAGGAACAACGTATC	mesoderm_PS1_Dfd
CGAGTTACAGTAGTTC	mesoderm_PS2_ken
CGGACACTCCCGGTAG	mesoderm_PS2_ken
CGGCAGTGTTACCTTT	mesoderm_PS2_ken
CGGGCATAGCCACCGT	mesoderm_PS1_Dfd
CTAAGTGTCCTAGAGT	mesoderm_PS1_Dfd
CTACCTGAGCATACTC	mesoderm_PS2_ken
CTATCTAAGACCATTC	mesoderm_PS2_ken
CTCAGGGGTTCATCTT	mesoderm_PS2_ken
CTCATCGTCTTCCGTG	mesoderm_PS2_ken
CTCCCAATCCCGAACG	mesoderm_PS2_ken
CTCCTCCAGCAATAAC	mesoderm_PS2_ken
CTGGACGAGGTGCTGA	mesoderm_PS2_ken
CTGTATTCAGGAGGTT	mesoderm_PS1_Dfd
CTTCCGAGTTGAGTCT	mesoderm_PS1_Dfd
CTTGAGAGTCGGTAAG	mesoderm_PS2_ken
CTTTCGGAGGTCCCGT	mesoderm_PS1_Dfd
GAACTGTTCTTTGCAT	mesoderm_PS2_ken
GAAGCGATCCCTCATG	mesoderm_PS2_ken
GAGAAATAGTAAATGC	mesoderm_PS2_ken
GAGAGGTAGTGTTGAA	mesoderm_PS2_ken
GAGCTGCAGAGAGCAA	mesoderm_PS1_Dfd
GATCACACAGTGACCC	mesoderm_PS1_Dfd
GATGATCAGGTTCAGG	mesoderm_PS2_ken
GATGTTGTCAACCCGG	mesoderm_PS2_ken
GATTCTTAGATCGACG	mesoderm_PS1_Dfd
GCACTAACACCTGCAG	mesoderm_PS1_Dfd
GCCATTCGTTACCTGA	mesoderm_PS2_ken
GCCGTGACATCCGTTC	mesoderm_PS1_Dfd
GCTTGGGAGCATCGAG	mesoderm_PS1_Dfd
GGGAAGTAGTGGCCTC	mesoderm_PS2_ken
GGGAGTAGTCGCCACA	mesoderm_PS2_ken
GGGATCCGTACAGAAT	mesoderm_PS1_Dfd
GGGTAGATCGAAATCC	mesoderm_PS1_Dfd
GGGTGTCTCTGCTGAA	mesoderm_PS1_Dfd
GTAACACTCCTGGGAC	mesoderm_PS2_ken
GTCAAACAGGGAGTGG	mesoderm_PS1_Dfd
GTCAAACAGGTAGTAT	mesoderm_PS2_ken
GTCACGGAGTATGGCG	mesoderm_PS1_Dfd
GTCTCACTCTGCACCT	mesoderm_PS2_ken
GTCTTTACATCGAACT	mesoderm_PS2_ken
GTGGTTAAGGTATCTC	mesoderm_PS1_Dfd
TAAGCGTCACCGCTAG	mesoderm_PS1_Dfd
TACCCACAGGTTATAG	mesoderm_PS1_Dfd
TACCGGGTCGGAGTGA	mesoderm_PS2_ken
TACGGTACACCCTCTA	mesoderm_PS2_ken
TAGACCACAGTATTCG	mesoderm_PS1_Dfd
TAGAGTCTCATCGCAA	mesoderm_PS2_ken
TAGGAGGCAATCACGT	mesoderm_PS2_ken
TATCTTGAGACATATG	mesoderm_PS1_Dfd
TATGTTCGTGAGCCAA	mesoderm_PS1_Dfd
TATTCCAGTCGTCATA	mesoderm_PS2_ken
TATTGGGGTAGGTTTC	mesoderm_PS2_ken
TCACAAGGTATGAAGT	mesoderm_PS2_ken
TCACTCGTCACACCGG	mesoderm_PS2_ken
TCATCCGAGGCATGCA	mesoderm_PS1_Dfd
TCCAGAAGTCTACGTA	mesoderm_PS1_Dfd
TCGGGACAGGTGTGAC	mesoderm_PS2_ken
TCGGTCTTCTATCGGA	mesoderm_PS2_ken
TCTCCGATCTGCTTTA	mesoderm_PS2_ken
TCTGCCACACCCAACG	mesoderm_PS1_Dfd
TCTTAGTTCACCTCGT	mesoderm_PS2_ken
TCTTTGAAGACCGTTT	mesoderm_PS1_Dfd
TGACAGTAGAAGCGCT	mesoderm_PS1_Dfd
TGAGCGCTCTATCCAT	mesoderm_PS2_ken
TGAGGGACAATGAGCG	mesoderm_PS2_ken
TGAGGTTTCGCTATTT	mesoderm_PS2_ken
TGATGGTTCGAGCCTG	mesoderm_PS2_ken
TGCCGAGAGAGTTGTA	mesoderm_PS1_Dfd
TGTGTGAGTGGGACAT	mesoderm_PS1_Dfd
TGTTACTGTATCGGTT	mesoderm_PS2_ken
TGTTCCGCAGAACTCT	mesoderm_PS2_ken
TGTTGGACACATTCTT	mesoderm_PS2_ken
TTCAGGACAGACTGCC	mesoderm_PS1_Dfd
TTCCAATCAATCTGCA	mesoderm_PS2_ken
TTCCGGTGTGGTCAAG	mesoderm_PS2_ken
TTCCTCTAGTTAGAAC	mesoderm_PS2_ken
TTTACTGAGCCTTCTC	mesoderm_PS2_ken
TTTAGTCCAAGGATGC	mesoderm_PS1_Dfd
TTTATGCCAAATACAG	mesoderm_PS2_ken
TTTATGCCATAGATCC	mesoderm_PS2_ken
