manual_ID
AAACGCTCAAGTAGTA	mesoderm_PS6
AAAGGATGTCGCACAC	mesoderm_PS4
AAAGGGCTCAGCACCG	mesoderm_PS4
AACAGGGTCATACAGC	mesoderm_PS6
AACGTCATCCCACAGG	mesoderm_PS4
AACTTCTGTACGATTC	mesoderm_PS6
AAGAACAAGGGTTAAT	mesoderm_PS4
AAGCATCGTGGAACAC	mesoderm_PS6
AAGGAATCATGGTACT	mesoderm_PS4
AAGTCGTTCAAGTGGG	mesoderm_PS4
AATAGAGGTATGACAA	mesoderm_PS6
ACACAGTAGAAGCGCT	mesoderm_PS6
ACATCCCCAGTAGATA	mesoderm_PS6
ACCAACAGTCTTCATT	mesoderm_PS4
ACCCAAATCGAGTGGA	mesoderm_PS4
ACCTACCAGAAAGTCT	mesoderm_PS4
ACGGGTCCAGATCATC	mesoderm_PS6
ACGTACAAGTTTGAGA	mesoderm_PS6
ACTACGAAGAATACAC	mesoderm_PS6
ACTATCTTCCTGTTAT	mesoderm_PS6
ACTATGGGTGAGTGAC	mesoderm_PS4
ACTGCAAGTACCTAGT	mesoderm_PS4
AGACCCGCATAAGCGG	mesoderm_PS6
AGAGAGCTCGATGCAT	mesoderm_PS4
AGATAGACATTGACAC	mesoderm_PS6
AGCCACGAGGTACAGC	mesoderm_PS6
AGCCAGCTCCTCATAT	mesoderm_PS6
AGCCAGCTCTCTGACC	mesoderm_PS6
AGCGCCAAGTAGCTCT	mesoderm_PS4
AGCTACACAGGTCTCG	mesoderm_PS6
AGCTCAACAACTGAAA	mesoderm_PS4
AGGACTTGTTCCGCAG	mesoderm_PS6
AGGCTGCAGCCGAACA	mesoderm_PS6
AGGCTGCAGTCTTCCC	mesoderm_PS6
AGGGAGTAGCGAGGAG	mesoderm_PS6
AGGGTTTCATCTCCCA	mesoderm_PS6
AGTAACCAGGGTCTTT	mesoderm_PS4
AGTCACATCTCCTGTG	mesoderm_PS6
AGTCATGGTTCAACGT	mesoderm_PS6
AGTGATCCACAGTCAT	mesoderm_PS4
ATAGAGAGTATGGTTC	mesoderm_PS6
ATCACGATCACCTGTC	mesoderm_PS6
ATCACTTTCTGACAGT	mesoderm_PS4
ATCCATTAGTGCAAAT	mesoderm_PS4
ATCCATTCAACCAACT	mesoderm_PS4
ATCCTATCACATTACG	mesoderm_PS6
ATCGGATCAGAGGAAA	mesoderm_PS6
ATCGGCGCAACCAACT	mesoderm_PS4
ATGAAAGCAATTGCCA	mesoderm_PS6
ATGATCGGTTTACTTC	mesoderm_PS6
ATGGGAGGTTCTCGCT	mesoderm_PS4
ATTCATCCATAATCCG	mesoderm_PS4
ATTCATCTCTACGGGC	mesoderm_PS6
ATTTACCTCTGCTAGA	mesoderm_PS4
CAACAACAGCTAGCCC	mesoderm_PS6
CAACAGTAGCCGGAAT	mesoderm_PS4
CAACCAAGTACCCACG	mesoderm_PS4
CAAGGGAAGCGCACAA	mesoderm_PS6
CAATGACCACAACGCC	mesoderm_PS4
CACAGATAGGAGTATT	mesoderm_PS6
CAGATACTCGGCATCG	mesoderm_PS4
CAGATTGGTTAGGGTG	mesoderm_PS4
CAGGGCTCAAAGAACT	mesoderm_PS6
CAGGTATGTCGTGATT	mesoderm_PS6
CATCCCACACCTATCC	mesoderm_PS6
CATGCCTAGGACTATA	mesoderm_PS4
CATGCCTCACCTCTAC	mesoderm_PS6
CATGGATAGGGAGAAT	mesoderm_PS6
CATTCCGGTACCGTCG	mesoderm_PS4
CATTGCCAGTTGCTCA	mesoderm_PS4
CATTGCCTCGTTCTCG	mesoderm_PS6
CCACTTGAGAGCAAGA	mesoderm_PS6
CCCAACTCACAATGAA	mesoderm_PS6
CCCAACTTCTCTCCGA	mesoderm_PS6
CCCATTGAGAGTCCGA	mesoderm_PS4
CCGATCTCAGTAACAA	mesoderm_PS6
CCTAACCTCCTTTGAT	mesoderm_PS4
CCTCATGTCGCGAAGA	mesoderm_PS6
CCTCCAACATGAGAAT	mesoderm_PS4
CCTTGTGTCTCTGCTG	mesoderm_PS4
CCTTTGGCACAAGTGG	mesoderm_PS4
CGAATTGTCCATGATG	mesoderm_PS6
CGCATAATCTGGCCTT	mesoderm_PS6
CGCATGGAGTGCCCGT	mesoderm_PS6
CGCATGGTCAAACCCA	mesoderm_PS4
CGCCAGAAGCTGCGAA	mesoderm_PS4
CGCCATTGTAACGTTC	mesoderm_PS6
CGGGACTCACCCTTAC	mesoderm_PS4
CGGGTGTAGGAAGTCC	mesoderm_PS4
CGTGAATCAACTCCAA	mesoderm_PS4
CGTTCTGCACTATCGA	mesoderm_PS6
CTAAGTGCATGTTACG	mesoderm_PS6
CTAAGTGGTTTGGGTT	mesoderm_PS6
CTACAGAGTTCGGCCA	mesoderm_PS6
CTATCTAAGGTTCAGG	mesoderm_PS4
CTCCCAACACATTCGA	mesoderm_PS4
CTGAATGCAAATCAAG	mesoderm_PS6
CTGCGAGCACCAACAT	mesoderm_PS6
CTGCGAGTCGTGGGAA	mesoderm_PS4
CTGCTCAAGGGTGGGA	mesoderm_PS6
CTGTGAACATAACAGA	mesoderm_PS4
CTTCCTTGTCGTCATA	mesoderm_PS6
CTTGATTTCGTTGCCT	mesoderm_PS4
GAAACCTCACAGTCCG	mesoderm_PS4
GAACACTGTTGCATGT	mesoderm_PS4
GAAGAATCAGCGGTTC	mesoderm_PS4
GAAGAATCATCATCCC	mesoderm_PS4
GAAGCGAGTTCAACGT	mesoderm_PS6
GAAGGACCACGCTGCA	mesoderm_PS6
GAAGTAATCATCTATC	mesoderm_PS6
GAAGTAATCGGCTTCT	mesoderm_PS4
GAATAGAGTCATCAGT	mesoderm_PS4
GACAGCCAGTGAGTTA	mesoderm_PS6
GACCCTTAGGCCACTC	mesoderm_PS6
GACTCAATCCCGTAAA	mesoderm_PS4
GACTCTCTCAATCCGA	mesoderm_PS6
GAGACTTGTACATTGC	mesoderm_PS4
GAGATGGGTGTTACTG	mesoderm_PS6
GAGCCTGGTGTCTTCC	mesoderm_PS6
GAGTGTTAGAACGTGC	mesoderm_PS6
GAGTGTTAGTGTACAA	mesoderm_PS4
GAGTTACAGGCTATCT	mesoderm_PS4
GAGTTGTCAATAACGA	mesoderm_PS4
GATCAGTTCTTTGATC	mesoderm_PS6
GATCATGGTGTAGCAG	mesoderm_PS4
GATCGTACAACTGTGT	mesoderm_PS6
GATCGTACAATGTCAC	mesoderm_PS6
GCACATAGTTCGTGCG	mesoderm_PS6
GCAGCTGGTGATAGTA	mesoderm_PS6
GCGAGAAGTCGCCTAG	mesoderm_PS6
GCGGAAATCTATTTCG	mesoderm_PS4
GCTGCAGTCAATCTTC	mesoderm_PS6
GCTGGGTCACGACGCT	mesoderm_PS4
GCTTGGGAGACGACTG	mesoderm_PS6
GGAACCCCATGTGGCC	mesoderm_PS4
GGAATCTCAAACTGCT	mesoderm_PS6
GGAATCTCAATCAGCT	mesoderm_PS6
GGAATGGAGATTGAGT	mesoderm_PS6
GGAGGATTCTCTGCCA	mesoderm_PS4
GGAGGTAGTCGGTACC	mesoderm_PS4
GGATCTATCGCTGTCT	mesoderm_PS4
GGCTGTGCATGAAGCG	mesoderm_PS6
GGGACAATCCATACAG	mesoderm_PS6
GGGACCTGTGTACATC	mesoderm_PS4
GGGAGATTCTCGAACA	mesoderm_PS6
GGGATGAGTAGGCTCC	mesoderm_PS6
GGGATGATCCTCCACA	mesoderm_PS4
GGGCTACGTGCAATGG	mesoderm_PS4
GGGTGTCAGTCTACCA	mesoderm_PS4
GGGTTTATCCATTCGC	mesoderm_PS4
GGTAACTCATTACTCT	mesoderm_PS4
GGTCTGGAGATCGCCC	mesoderm_PS6
GTCATGAAGATGCTAA	mesoderm_PS4
GTCATTTGTTGCATAC	mesoderm_PS6
GTCCTCATCGTTCAGA	mesoderm_PS4
GTCGAATGTAGGGTAC	mesoderm_PS4
GTGAGCCTCCTCTAGC	mesoderm_PS4
GTGAGTTTCACTCCGT	mesoderm_PS4
GTGCAGCTCCTGTACC	mesoderm_PS6
GTGCTGGAGTTGAAAC	mesoderm_PS6
GTGCTGGTCGCCGAGT	mesoderm_PS4
GTGTGATTCCCGTGTT	mesoderm_PS6
GTTACAGTCATTCACT	mesoderm_PS4
GTTACCCCATCGCTGG	mesoderm_PS6
GTTAGTGTCTACCAGA	mesoderm_PS6
GTTCCGTCAGCCTACG	mesoderm_PS4
GTTTACTCACCAGTTA	mesoderm_PS6
TAATTCCTCTCGACGG	mesoderm_PS6
TACATTCAGATTAGTG	mesoderm_PS6
TACCTGCGTCCACGCA	mesoderm_PS6
TACGCTCGTGACCGTC	mesoderm_PS6
TACTTGTTCTGAGCAT	mesoderm_PS4
TAGGGTTCATGCAGGA	mesoderm_PS4
TATCCTATCGGAATGG	mesoderm_PS4
TATTGCTAGGTTCACT	mesoderm_PS4
TCAGGGCGTAACAGTA	mesoderm_PS4
TCAGTGAAGCAGGGAG	mesoderm_PS4
TCATACTGTACCGTGC	mesoderm_PS6
TCATCATAGTCGGCCT	mesoderm_PS4
TCATGTTCATGTCAGT	mesoderm_PS4
TCCCATGTCGAGTGAG	mesoderm_PS4
TCCTCCCTCCCAGGAC	mesoderm_PS4
TCGACGGAGTCGCTAT	mesoderm_PS4
TCGATTTGTTAGGGAC	mesoderm_PS4
TCGCTTGTCCACCTGT	mesoderm_PS6
TCGGGCAGTCGCATCG	mesoderm_PS4
TCGGGTGCACGGAAGT	mesoderm_PS6
TCGTCCAAGAACCCGA	mesoderm_PS6
TCTACATCAGTTACCA	mesoderm_PS6
TCTACCGCAGGCCTGT	mesoderm_PS4
TCTACCGGTGCTCCGA	mesoderm_PS6
TCTCAGCCAGGCATGA	mesoderm_PS4
TGAACGTGTTATTCCT	mesoderm_PS6
TGAATGCGTATTGACC	mesoderm_PS6
TGAATGCTCGTCAAAC	mesoderm_PS6
TGACAGTTCTGAATGC	mesoderm_PS6
TGACCCTCACGACGAA	mesoderm_PS4
TGAGACTCAAGTGATA	mesoderm_PS6
TGAGGAGTCCTTTGAT	mesoderm_PS4
TGAGGGAGTATCATGC	mesoderm_PS6
TGAGTCAAGAAATTGC	mesoderm_PS6
TGATCAGGTATTGGCT	mesoderm_PS4
TGATTTCTCTAACGCA	mesoderm_PS6
TGCGACGTCCTAGCCT	mesoderm_PS4
TGGAGAGAGAACCGCA	mesoderm_PS4
TGGGATTGTACAGTCT	mesoderm_PS6
TGGGCGTCACCTGATA	mesoderm_PS6
TGTACAGCATCACAGT	mesoderm_PS6
TGTAGACTCCCAATAG	mesoderm_PS4
TGTGATGCAGTATGAA	mesoderm_PS6
TGTGCGGTCGCATAGT	mesoderm_PS6
TGTTCCGCAGTTAGAA	mesoderm_PS4
TTACGCCAGTATGGCG	mesoderm_PS4
TTCATTGTCAGCTAGT	mesoderm_PS4
TTCCGTGCACTGGCGT	mesoderm_PS6
TTGATGGAGCCACAAG	mesoderm_PS4
TTGATGGCAATAGGGC	mesoderm_PS6
TTGTGGACAGCTGTCG	mesoderm_PS6
TTGTTGTTCCGGCTTT	mesoderm_PS6
TTGTTTGAGGGCCTCT	mesoderm_PS4
TTGTTTGTCGGTAAGG	mesoderm_PS6
TTTACGTTCGGCATAT	mesoderm_PS6
TTTACTGGTTCTAAGC	mesoderm_PS4
TTTGACTGTAGGCAAC	mesoderm_PS4
TTTGGTTAGCAAGTGC	mesoderm_PS4
AAACGAAGTGACCGAA	mesoderm_abdominal_odd
AAACGCTAGCGTCAGA	mesoderm_abdominal_even
AAACGCTTCCACGTGG	mesoderm_abdominal_odd
AAAGGATAGTTCCGGC	mesoderm_abdominal_even
AAAGGATCAGCTGTCG	mesoderm_abdominal_odd
AAAGGTACAGAACTTC	mesoderm_abdominal_even
AAAGTCCAGCAAGCCA	mesoderm_abdominal_odd
AAAGTCCTCATCGACA	mesoderm_PS3
AAAGTGAAGACGATAT	mesoderm_PS5
AAAGTGAAGAGTCCGA	mesoderm_abdominal_even
AAAGTGAAGTCACGAG	mesoderm_PS5
AAATGGAGTCACTGAT	mesoderm_abdominal_even
AACAAAGAGAGTGAAG	mesoderm_abdominal_even
AACAAAGAGCTGCGAA	mesoderm_abdominal_odd
AACAAAGGTCCGCAGT	mesoderm_PS5
AACAACCCAATGGCCC	mesoderm_abdominal_even
AACAACCTCCCGTGAG	mesoderm_abdominal_even
AACAGGGCAGGTCAGA	mesoderm_abdominal_odd
AACCAACAGCGCTGAA	mesoderm_abdominal_odd
AACCAACCACCTGTCT	mesoderm_abdominal_odd
AACCAACCATCGGAAG	mesoderm_abdominal_even
AACCAACGTGGCAACA	mesoderm_PS5
AACCACACAGTTTCAG	mesoderm_abdominal_odd
AACCACATCATTTGCT	mesoderm_abdominal_odd
AACCATGAGTTTGTCG	mesoderm_abdominal_odd
AACCATGGTATATGGA	mesoderm_abdominal_even
AACCATGTCAAGCCAT	mesoderm_abdominal_odd
AACCCAACAATCGTCA	mesoderm_abdominal_odd
AACCCAAGTCTAGGTT	mesoderm_abdominal_even
AACCTGAGTAATGATG	mesoderm_abdominal_odd
AACCTTTCAACTCATG	mesoderm_abdominal_even
AACGAAAAGGACGCAT	mesoderm_abdominal_odd
AACGAAATCGGCTTCT	mesoderm_abdominal_odd
AACGTCAAGCTAATCC	mesoderm_PS3
AACGTCAGTGGGTTGA	mesoderm_PS3
AACGTCATCTATTGTC	mesoderm_PS5
AACGTCATCTTACCAT	mesoderm_PS3
AAGAACAAGCCATTCA	mesoderm_PS5
AAGAACAAGTCTGGTT	mesoderm_PS5
AAGCATCAGGTGTGAC	mesoderm_abdominal_odd
AAGCGAGTCCGCATAA	mesoderm_abdominal_even
AAGTACCGTATGAGAT	mesoderm_abdominal_even
AAGTACCGTCGCATTA	mesoderm_abdominal_odd
AAGTACCGTTTCGGCG	mesoderm_abdominal_odd
AAGTCGTAGCGCGTTC	mesoderm_abdominal_even
AAGTCGTGTGTGGACA	mesoderm_PS5
AAGTGAATCTGCGGCA	mesoderm_abdominal_odd
AAGTTCGCACAGCCTG	mesoderm_abdominal_even
AAGTTCGTCGAGTGGA	mesoderm_PS5
AATAGAGCATCATCCC	mesoderm_abdominal_odd
AATCACGCATCCTTGC	mesoderm_abdominal_odd
AATCACGTCTAAGGAA	mesoderm_abdominal_odd
AATCGACTCACTACGA	mesoderm_abdominal_even
AATGAAGAGGTAACTA	mesoderm_abdominal_odd
AATGAAGGTACTGCGC	mesoderm_abdominal_odd
AATGACCTCCAACCAA	mesoderm_PS5
AATGGCTAGCCTTTGA	mesoderm_abdominal_odd
AATGGCTAGGTATTGA	mesoderm_PS5
AATGGCTCAATACCTG	mesoderm_abdominal_even
AATGGCTCACAGTCCG	mesoderm_PS5
AATGGCTTCGCTACAA	mesoderm_abdominal_odd
AATTCCTCACATTACG	mesoderm_abdominal_even
AATTCCTTCAAGTGGG	mesoderm_PS3
AATTTCCAGGATTCAA	mesoderm_abdominal_odd
ACAAAGACAGGCTATT	mesoderm_abdominal_odd
ACAAAGATCCCGATCT	mesoderm_abdominal_odd
ACAACCAAGCACAAAT	mesoderm_PS5
ACAACCAGTAGGACTG	mesoderm_abdominal_even
ACAACCATCGTTCGCT	mesoderm_abdominal_even
ACAAGCTAGTAAGAGG	mesoderm_abdominal_odd
ACAAGCTGTACCGCGT	mesoderm_PS5
ACAAGCTGTGATAGAT	mesoderm_PS5
ACACAGTAGTGCCCGT	mesoderm_abdominal_even
ACACAGTCATCTTCGC	mesoderm_PS5
ACACAGTGTCTTGAGT	mesoderm_abdominal_even
ACACCAAAGCATCAGG	mesoderm_PS5
ACACTGAGTGCTTATG	mesoderm_PS5
ACAGCCGGTAGAATGT	mesoderm_abdominal_even
ACAGCCGTCCGCTAGG	mesoderm_PS5
ACAGGGACACGTACAT	mesoderm_PS5
ACAGGGATCTGATGGT	mesoderm_abdominal_odd
ACATCCCAGGCCGCTT	mesoderm_abdominal_even
ACATCCCGTACGTTCA	mesoderm_abdominal_odd
ACATTTCCAATTCACG	mesoderm_abdominal_even
ACCAAACAGCCAACCC	mesoderm_PS5
ACCAAACCAGCACGAA	mesoderm_abdominal_odd
ACCAAACGTATCGATC	mesoderm_abdominal_even
ACCAAACGTGTGATGG	mesoderm_abdominal_odd
ACCAAACTCTTTCCGG	mesoderm_abdominal_even
ACCACAAAGAATCTAG	mesoderm_abdominal_odd
ACCACAAAGGTAGTAT	mesoderm_PS5
ACCACAACAGGATTCT	mesoderm_abdominal_even
ACCCAAAAGAGTCCGA	mesoderm_PS5
ACCCTCAAGGGACACT	mesoderm_abdominal_odd
ACCCTCACACATGTTG	mesoderm_abdominal_odd
ACCCTTGTCGACCATA	mesoderm_PS5
ACCGTTCTCAAGCGTT	mesoderm_abdominal_odd
ACCGTTCTCGCTGTCT	mesoderm_PS3
ACCTACCAGTCAAGCG	mesoderm_abdominal_odd
ACCTGAAGTATGTGTC	mesoderm_abdominal_odd
ACCTGAATCGTCTAAG	mesoderm_abdominal_even
ACCTGTCAGAGCAGCT	mesoderm_abdominal_odd
ACCTGTCAGGGCTAAC	mesoderm_abdominal_odd
ACCTGTCCATGGCACC	mesoderm_abdominal_odd
ACCTGTCTCAATCTCT	mesoderm_abdominal_odd
ACGATGTTCTCATTGT	mesoderm_abdominal_even
ACGCACGCACAGCATT	mesoderm_abdominal_even
ACGCACGCAGCTTTCC	mesoderm_abdominal_odd
ACGCACGTCTAGGAAA	mesoderm_abdominal_even
ACGGAAGGTCCCAAAT	mesoderm_abdominal_odd
ACGGGTCGTTGTGCCG	mesoderm_abdominal_even
ACGGTCGCACCTAAAC	mesoderm_abdominal_odd
ACGGTCGTCTGGCCTT	mesoderm_abdominal_odd
ACGGTTAAGTATGGAT	mesoderm_abdominal_odd
ACGGTTACAGCGAACA	mesoderm_PS5
ACGTAACTCGGTCGGT	mesoderm_abdominal_odd
ACGTACATCTACTGCC	mesoderm_PS5
ACGTCCTAGGCTATCT	mesoderm_abdominal_even
ACGTCCTAGTGCGACA	mesoderm_abdominal_even
ACGTTCCGTTGAGAGC	mesoderm_abdominal_even
ACTACGAAGCGGCTCT	mesoderm_abdominal_even
ACTACGATCAGACTGT	mesoderm_abdominal_odd
ACTATCTGTAGCGTTT	mesoderm_PS5
ACTATGGAGAGCAAGA	mesoderm_PS5
ACTATGGCACGACGTC	mesoderm_PS5
ACTCCCACATCGTGGC	mesoderm_abdominal_even
ACTCTCGGTATGCGTT	mesoderm_abdominal_even
ACTGCAAAGTTGCTGT	mesoderm_abdominal_even
ACTGTGATCCGTGCGA	mesoderm_abdominal_odd
ACTGTGATCGACCACG	mesoderm_abdominal_odd
ACTTAGGCAAGAGTTA	mesoderm_abdominal_even
ACTTAGGTCCAAATGC	mesoderm_abdominal_odd
ACTTCCGCAGCAGACA	mesoderm_abdominal_odd
ACTTCCGTCTAGCAAC	mesoderm_PS5
ACTTCGCCAGACGCTC	mesoderm_abdominal_odd
ACTTCGCCAGTCCCGA	mesoderm_PS5
ACTTCGCGTATCACCA	mesoderm_abdominal_odd
AGAAATGCAATTGAGA	mesoderm_abdominal_odd
AGAACAATCATTTCGT	mesoderm_abdominal_odd
AGAACAATCCGATAAC	mesoderm_PS5
AGAACCTAGATGCTTC	mesoderm_abdominal_odd
AGAAGCGGTATCGAAA	mesoderm_abdominal_even
AGAAGTAAGCTGGCTC	mesoderm_abdominal_even
AGAAGTAGTTGCATAC	mesoderm_abdominal_even
AGAAGTATCAATCCAG	mesoderm_abdominal_odd
AGACAAACATAACGGG	mesoderm_PS5
AGACACTGTGCTGATT	mesoderm_PS3
AGACAGGTCGATTTCT	mesoderm_abdominal_even
AGACAGGTCGCTCCTA	mesoderm_PS5
AGACCATCACTAAACC	mesoderm_PS5
AGACCATTCATGGTAC	mesoderm_abdominal_even
AGACCCGAGGTGCATG	mesoderm_abdominal_odd
AGACCCGGTACTCGCG	mesoderm_abdominal_even
AGAGAGCAGTGAGGTC	mesoderm_PS5
AGAGAGCGTATTGACC	mesoderm_PS5
AGAGCAGGTCCGGATC	mesoderm_abdominal_odd
AGAGCCCTCTAGACAC	mesoderm_PS3
AGATCCACACGATAGG	mesoderm_abdominal_odd
AGATCCACAGTGGCTC	mesoderm_abdominal_even
AGCATCACATGGCGCT	mesoderm_abdominal_even
AGCCAGCTCACCCTTG	mesoderm_PS5
AGCCAGCTCTATTGTC	mesoderm_abdominal_odd
AGCGATTAGAGTCAGC	mesoderm_PS5
AGCGATTCATCATTTC	mesoderm_abdominal_even
AGCGCCAAGGTAGTAT	mesoderm_PS5
AGCGCTGAGAGAGCAA	mesoderm_PS5
AGCGCTGCATGAAGGC	mesoderm_abdominal_even
AGCGTCGAGAGAGAAC	mesoderm_abdominal_even
AGCTACAAGAAACACT	mesoderm_abdominal_even
AGCTCAAGTCCAAGAG	mesoderm_PS5
AGCTTCCAGTTAGTAG	mesoderm_abdominal_odd
AGGAATACATGACACT	mesoderm_abdominal_odd
AGGACGACAAGTCGTT	mesoderm_abdominal_odd
AGGACGACAGTAGAAT	mesoderm_abdominal_even
AGGACGATCGATCCCT	mesoderm_abdominal_odd
AGGACTTGTACGAGTG	mesoderm_abdominal_odd
AGGACTTGTCACAATC	mesoderm_abdominal_even
AGGATCTGTGTTTGCA	mesoderm_abdominal_odd
AGGCATTCAAGCTGCC	mesoderm_PS3
AGGCATTGTGGTCAAG	mesoderm_abdominal_even
AGGCATTTCGGAGATG	mesoderm_abdominal_odd
AGGCATTTCTCCGTGT	mesoderm_abdominal_odd
AGGGAGTCAAATCAAG	mesoderm_abdominal_even
AGGGAGTGTCCAGCAC	mesoderm_PS5
AGGGCTCAGTATAGGT	mesoderm_abdominal_odd
AGGGTCCGTCTGATAC	mesoderm_abdominal_odd
AGGGTGATCATCACCC	mesoderm_abdominal_odd
AGGGTTTCAACCGTGC	mesoderm_PS5
AGGGTTTGTTCACGAT	mesoderm_abdominal_even
AGGTAGGAGGTAAACT	mesoderm_abdominal_odd
AGGTAGGCAATTCTCT	mesoderm_PS5
AGGTAGGCATGATAGA	mesoderm_abdominal_even
AGGTAGGTCCGCTAGG	mesoderm_PS3
AGGTCATAGAGCCCAA	mesoderm_PS3
AGGTCATTCACCTTAT	mesoderm_PS3
AGGTCATTCGTAACCA	mesoderm_PS3
AGGTCTAAGTTGGACG	mesoderm_abdominal_even
AGGTGTTAGAAAGTCT	mesoderm_abdominal_odd
AGGTGTTTCCTGGGAC	mesoderm_abdominal_odd
AGGTTACTCCTTCACG	mesoderm_abdominal_even
AGGTTGTGTAGTCTGT	mesoderm_abdominal_even
AGTAACCTCGGAAGGT	mesoderm_abdominal_odd
AGTACCAGTTTGAACC	mesoderm_abdominal_odd
AGTACTGAGAGATGCC	mesoderm_abdominal_odd
AGTAGTCTCACCGCTT	mesoderm_abdominal_even
AGTCACAAGTTCATCG	mesoderm_abdominal_odd
AGTCACATCCCTCTAG	mesoderm_abdominal_odd
AGTCTCCCAGTCGTTA	mesoderm_abdominal_odd
AGTCTCCTCTGGAAGG	mesoderm_abdominal_odd
AGTGCCGAGAGCCCAA	mesoderm_PS3
AGTGCCGAGCATGGGT	mesoderm_abdominal_even
AGTGCCGCAAAGACTA	mesoderm_abdominal_odd
AGTGTTGCAGAACGCA	mesoderm_abdominal_odd
AGTGTTGGTGACGTCC	mesoderm_abdominal_odd
AGTTAGCGTCCTGGGT	mesoderm_PS5
AGTTCCCTCTCGGTCT	mesoderm_abdominal_odd
AGTTCGACAAAGGAGA	mesoderm_abdominal_even
AGTTCGAGTGGATCGA	mesoderm_abdominal_even
ATACTTCAGCCACAAG	mesoderm_abdominal_even
ATACTTCAGTTACGTC	mesoderm_PS5
ATAGAGATCATCACAG	mesoderm_abdominal_even
ATAGGCTAGTATGGCG	mesoderm_PS5
ATCACAGCACACCGCA	mesoderm_abdominal_even
ATCACTTAGCTGAGCA	mesoderm_abdominal_odd
ATCACTTAGTGGACTG	mesoderm_abdominal_odd
ATCACTTGTTTGAAAG	mesoderm_abdominal_odd
ATCAGGTTCAATCGGT	mesoderm_abdominal_odd
ATCATTCTCAAGTCTG	mesoderm_PS5
ATCCATTGTGAATATG	mesoderm_PS5
ATCCCTGAGGCGTTGA	mesoderm_abdominal_odd
ATCCCTGTCCTACGGG	mesoderm_abdominal_odd
ATCCCTGTCTGACCCT	mesoderm_abdominal_odd
ATCCGTCGTTAGGAGC	mesoderm_abdominal_even
ATCCGTCGTTTGGAAA	mesoderm_abdominal_even
ATCCGTCTCGTGTTCC	mesoderm_abdominal_odd
ATCCTATAGCGGATCA	mesoderm_abdominal_odd
ATCCTATGTCCTCAGG	mesoderm_abdominal_odd
ATCCTATGTTCCGGTG	mesoderm_abdominal_even
ATCCTATGTTGCGGAA	mesoderm_abdominal_odd
ATCGATGAGGTAGATT	mesoderm_PS3
ATCGCCTAGAACAGGA	mesoderm_abdominal_odd
ATCGGATAGAGGTCAC	mesoderm_abdominal_even
ATCGGATCACGAAAGC	mesoderm_abdominal_odd
ATCGGCGCATCGGAGA	mesoderm_abdominal_even
ATCGGCGGTTAATCGC	mesoderm_abdominal_odd
ATCGTAGTCAATCCAG	mesoderm_abdominal_even
ATCGTCCCAATTCACG	mesoderm_PS5
ATCTCTAAGTATGATG	mesoderm_abdominal_even
ATCTCTACACTGGACC	mesoderm_abdominal_even
ATCTTCACAAGTGACG	mesoderm_PS5
ATCTTCAGTATCAGGG	mesoderm_abdominal_even
ATCTTCAGTGTTGAGG	mesoderm_PS5
ATGAAAGCAGGCACTC	mesoderm_abdominal_even
ATGAAAGGTGAACCGA	mesoderm_PS5
ATGAAAGTCCTCTTTC	mesoderm_abdominal_odd
ATGAGGGGTGTGCTTA	mesoderm_abdominal_odd
ATGATCGAGGTACCTT	mesoderm_PS5
ATGCCTCGTTTCACTT	mesoderm_abdominal_even
ATGCGATAGACGGTTG	mesoderm_abdominal_even
ATGCGATGTTGCATAC	mesoderm_abdominal_odd
ATGCGATTCCACGGGT	mesoderm_abdominal_even
ATGCGATTCGAACACT	mesoderm_abdominal_even
ATGGAGGAGCTGGCCT	mesoderm_abdominal_odd
ATGGAGGCAGAGTGAC	mesoderm_abdominal_even
ATGGAGGTCAGGTGTT	mesoderm_abdominal_odd
ATGGGAGAGGCGACAT	mesoderm_abdominal_odd
ATGGGAGGTTGCTAGT	mesoderm_abdominal_even
ATGGGTTAGGAGAGGC	mesoderm_abdominal_even
ATGGGTTTCAATGTCG	mesoderm_PS3
ATGGTTGGTATTGACC	mesoderm_abdominal_odd
ATGTCTTAGGTCGTGA	mesoderm_abdominal_odd
ATTACCTTCTATCGCC	mesoderm_abdominal_even
ATTACTCTCTTGTGCC	mesoderm_PS3
ATTATCCCATATGGCT	mesoderm_abdominal_odd
ATTCACTTCATGAAAG	mesoderm_PS5
ATTCAGGCACCAGCGT	mesoderm_abdominal_even
ATTCAGGTCAGCTGTA	mesoderm_abdominal_even
ATTCATCGTCGCGGTT	mesoderm_PS5
ATTCCATAGCTGTTCA	mesoderm_abdominal_odd
ATTCCATTCATAGCAC	mesoderm_abdominal_even
ATTCCATTCGTCTACC	mesoderm_abdominal_odd
ATTCCCGGTACCGGCT	mesoderm_abdominal_odd
ATTCCTAAGCTCGTGC	mesoderm_abdominal_odd
ATTCCTAGTAAGATAC	mesoderm_PS3
ATTCGTTGTTGAGTCT	mesoderm_abdominal_odd
ATTCGTTTCTCGTTTA	mesoderm_abdominal_even
ATTGGGTCATCAGTCA	mesoderm_abdominal_odd
ATTGGGTGTACTCGAT	mesoderm_abdominal_even
ATTTACCTCGACCAAT	mesoderm_abdominal_odd
ATTTCACGTTCGTACA	mesoderm_abdominal_odd
CAAAGAAGTGGAACCA	mesoderm_abdominal_odd
CAACAGTAGCATATGA	mesoderm_abdominal_odd
CAACGATCAGAGGTAC	mesoderm_abdominal_odd
CAACGATGTTGCCGCA	mesoderm_abdominal_odd
CAACGATTCACCTGTC	mesoderm_abdominal_odd
CAACGATTCCGTGGTG	mesoderm_abdominal_odd
CAACGGCCACCCGTAG	mesoderm_abdominal_even
CAAGACTGTCCGAAGA	mesoderm_abdominal_even
CAAGAGGAGGGAGGGT	mesoderm_abdominal_even
CAAGAGGCACTAGTAC	mesoderm_PS3
CAAGCTAGTGTGCCTG	mesoderm_abdominal_even
CAAGGGACAACCACAT	mesoderm_abdominal_odd
CAATCGAAGGTAGCAC	mesoderm_abdominal_odd
CAATGACTCAATCCAG	mesoderm_abdominal_even
CAATTTCAGTGTTCCA	mesoderm_abdominal_even
CAATTTCCACGAGGAT	mesoderm_abdominal_even
CAATTTCGTCGCACAC	mesoderm_abdominal_even
CAATTTCGTTCCGGTG	mesoderm_PS3
CACAACACATAACAGA	mesoderm_abdominal_even
CACACAACAGAGAAAG	mesoderm_abdominal_odd
CACACAATCACCGCTT	mesoderm_abdominal_even
CACAGATAGCTTTGTG	mesoderm_abdominal_even
CACAGATCAGCTGTAT	mesoderm_abdominal_odd
CACATGATCTCTATGT	mesoderm_abdominal_even
CACCAAATCAAGAATG	mesoderm_abdominal_odd
CACGAATCACATAACC	mesoderm_PS5
CACGTGGAGGTTTGAA	mesoderm_abdominal_even
CACGTGGGTATACGGG	mesoderm_PS5
CACTAAGCATAGTCGT	mesoderm_abdominal_even
CACTGAATCATCCTGC	mesoderm_abdominal_even
CACTGAATCCACGGGT	mesoderm_abdominal_even
CACTGTCTCGTACACA	mesoderm_abdominal_odd
CAGAGCCTCCATATGG	mesoderm_abdominal_odd
CAGATACAGGTAAACT	mesoderm_PS3
CAGATCAGTTCTAAGC	mesoderm_PS5
CAGATTGCAGTCTTCC	mesoderm_abdominal_odd
CAGATTGCATGGCTAT	mesoderm_PS5
CAGCACGCATAATGAG	mesoderm_abdominal_even
CAGCACGGTGCGCTCA	mesoderm_PS5
CAGCAGCGTTGGCTAT	mesoderm_abdominal_odd
CAGCCAGGTGCGGCTT	mesoderm_abdominal_odd
CAGGTATCATGGGCAA	mesoderm_abdominal_even
CAGTTCCAGAATGTTG	mesoderm_abdominal_odd
CATAAGCAGCGTTGTT	mesoderm_abdominal_odd
CATAAGCTCTCTGACC	mesoderm_abdominal_even
CATACAGAGCGTCAGA	mesoderm_abdominal_even
CATACCCAGGAGAGTA	mesoderm_PS3
CATACCCTCAAGTGGG	mesoderm_abdominal_odd
CATACTTCATCATCCC	mesoderm_PS5
CATCAAGTCTTGCAAG	mesoderm_abdominal_odd
CATCCCAAGTTGAATG	mesoderm_abdominal_odd
CATCCGTAGACGCAGT	mesoderm_abdominal_even
CATCGGGTCGTCGATA	mesoderm_abdominal_odd
CATGCAACAAGGACAC	mesoderm_abdominal_even
CATGCAACACCGCTGA	mesoderm_abdominal_odd
CATGCAAGTAGCTTAC	mesoderm_abdominal_even
CATGCGGAGCTCCCTT	mesoderm_abdominal_odd
CATGGATGTACGCTTA	mesoderm_abdominal_odd
CATTCATCAGAGTTCT	mesoderm_PS3
CATTCATTCTCAGTCC	mesoderm_PS5
CATTCCGGTAGCTAAA	mesoderm_PS3
CATTCTACAATGACCT	mesoderm_abdominal_odd
CATTCTAGTCTAGGTT	mesoderm_PS5
CATTCTAGTCTTTCAT	mesoderm_abdominal_even
CATTCTATCTGCGATA	mesoderm_PS5
CATTGTTTCACAGAGG	mesoderm_abdominal_even
CATTTCAAGACACACG	mesoderm_abdominal_even
CATTTCACACCACTGG	mesoderm_abdominal_odd
CCAATGACACGGTGTC	mesoderm_abdominal_odd
CCAATGAGTTGTCATG	mesoderm_abdominal_odd
CCAATGATCATTGCGA	mesoderm_PS5
CCAATTTGTATGCGGA	mesoderm_PS5
CCACAAAGTCGTACTA	mesoderm_PS5
CCACCATAGAAACTCA	mesoderm_abdominal_odd
CCACCATAGTCAGGGT	mesoderm_abdominal_even
CCACCATTCCGGTAGC	mesoderm_abdominal_odd
CCACGAGAGTGCGACA	mesoderm_abdominal_even
CCACGAGCACTTCAAG	mesoderm_abdominal_odd
CCACGAGGTGGTCAAG	mesoderm_abdominal_even
CCACGTTAGGTCCAGA	mesoderm_abdominal_even
CCACTTGAGGCGAAGG	mesoderm_abdominal_odd
CCATCACGTTCGTTCC	mesoderm_abdominal_even
CCCAACTAGCCATTGT	mesoderm_abdominal_even
CCCAACTTCGTGACTA	mesoderm_abdominal_even
CCCGAAGTCGTTCTCG	mesoderm_abdominal_even
CCCGGAACAAGACCTT	mesoderm_abdominal_even
CCCGGAAGTCTCTCCA	mesoderm_abdominal_odd
CCCTCAACATCCGGTG	mesoderm_PS3
CCCTCTCAGCATCAAA	mesoderm_abdominal_even
CCCTCTCCAAGTGACG	mesoderm_abdominal_even
CCCTTAGGTCAGGCAA	mesoderm_abdominal_even
CCGATCTCAGGCTACC	mesoderm_abdominal_odd
CCGATCTTCCAAGCTA	mesoderm_abdominal_even
CCGATCTTCCTCCACA	mesoderm_abdominal_even
CCGATGGGTGATTCAC	mesoderm_abdominal_odd
CCGGTAGAGGTATTGA	mesoderm_PS3
CCGTTCAAGGACATCG	mesoderm_abdominal_even
CCGTTCATCACTGGGC	mesoderm_abdominal_even
CCTAAGAAGTGATCGG	mesoderm_abdominal_even
CCTAAGAGTAACGCGA	mesoderm_abdominal_odd
CCTAAGAGTCAATGGG	mesoderm_abdominal_odd
CCTATCGCAAGTTGGG	mesoderm_abdominal_odd
CCTCAACCAGAACTAA	mesoderm_abdominal_odd
CCTCAGTTCAAAGACA	mesoderm_abdominal_even
CCTCAGTTCTTGCAAG	mesoderm_abdominal_odd
CCTCCAAGTCAGGCAA	mesoderm_PS3
CCTCCTCTCTCTATAC	mesoderm_PS5
CCTCTAGGTTTACCTT	mesoderm_abdominal_even
CCTCTAGTCCGGTAAT	mesoderm_abdominal_even
CCTCTCCCACTTCATT	mesoderm_abdominal_even
CCTGCATTCGAGTCCG	mesoderm_abdominal_even
CCTTGTGAGTCTGGAG	mesoderm_abdominal_odd
CCTTGTGCAACGATCT	mesoderm_abdominal_odd
CCTTTGGCAGATACTC	mesoderm_abdominal_odd
CGAAGTTGTGCTCTCT	mesoderm_abdominal_even
CGAATTGAGAGAATCT	mesoderm_PS3
CGAGAAGCACCCATAA	mesoderm_PS3
CGAGGAAGTCTCAGGC	mesoderm_abdominal_odd
CGAGGCTAGTGACACG	mesoderm_abdominal_even
CGAGTTACAGAGGAAA	mesoderm_abdominal_even
CGATGGCAGCCACAAG	mesoderm_PS3
CGCATAAGTCACAGTT	mesoderm_abdominal_even
CGCATGGAGCACGTCC	mesoderm_abdominal_even
CGCATGGAGGGAGTTC	mesoderm_abdominal_odd
CGCCATTAGGTATAGT	mesoderm_abdominal_odd
CGCCATTGTGCTGTCG	mesoderm_abdominal_even
CGGAACCGTCCACAGC	mesoderm_abdominal_odd
CGGAATTGTAGGACCA	mesoderm_abdominal_even
CGGAGAAAGACCAGAC	mesoderm_abdominal_even
CGGCAGTCAGGCACTC	mesoderm_abdominal_odd
CGGGACTAGAATAGTC	mesoderm_abdominal_even
CGGGACTTCTCGACCT	mesoderm_PS3
CGGGTCACAGTGGGTA	mesoderm_abdominal_odd
CGGGTCACATCGGCCA	mesoderm_abdominal_odd
CGGTCAGAGATCCCGC	mesoderm_PS5
CGTAAGTGTGGAACAC	mesoderm_PS5
CGTAATGAGGTAGGCT	mesoderm_abdominal_even
CGTAGTACATGATCTG	mesoderm_PS5
CGTAGTAGTTTCGTGA	mesoderm_abdominal_even
CGTCCATAGGATTTGA	mesoderm_PS5
CGTGAATCAGTTGTCA	mesoderm_abdominal_odd
CGTTCTGCACTCTAGA	mesoderm_abdominal_odd
CGTTCTGTCCTACCAC	mesoderm_abdominal_odd
CTAACCCAGAGTATAC	mesoderm_abdominal_odd
CTAACCCCAGCGTGAA	mesoderm_PS5
CTAAGTGCAGCTACTA	mesoderm_abdominal_odd
CTAAGTGTCACTTGTT	mesoderm_abdominal_odd
CTACCTGAGGCCTGCT	mesoderm_PS5
CTACTATAGCTGTACT	mesoderm_abdominal_odd
CTACTATCACACCTTC	mesoderm_abdominal_odd
CTACTATGTATAGGGC	mesoderm_abdominal_odd
CTACTATGTGTTCATG	mesoderm_PS5
CTAGACAGTGCTCGTG	mesoderm_abdominal_even
CTATAGGTCCTCATAT	mesoderm_PS5
CTATCTAAGGCACTAG	mesoderm_abdominal_even
CTATCTACAGGCATGA	mesoderm_abdominal_even
CTATCTAGTTGTTTGG	mesoderm_PS5
CTCACTGCAAAGGATT	mesoderm_abdominal_even
CTCACTGGTGTGCCTG	mesoderm_abdominal_even
CTCAGAACACGATTCA	mesoderm_abdominal_odd
CTCAGAACACTTGAGT	mesoderm_abdominal_even
CTCAGAACAGACAAGC	mesoderm_abdominal_odd
CTCAGGGCATTGTACG	mesoderm_abdominal_even
CTCAGTCTCTGGACCG	mesoderm_abdominal_even
CTCATCGGTCCACAGC	mesoderm_PS5
CTCATCGTCCTTTGAT	mesoderm_abdominal_even
CTCATGCTCATTCATC	mesoderm_abdominal_odd
CTCATTATCAGTGATC	mesoderm_abdominal_even
CTCCAACAGGCCATAG	mesoderm_abdominal_even
CTCCACAAGCATGCGA	mesoderm_abdominal_even
CTCCATGTCACGGGCT	mesoderm_abdominal_odd
CTCCCAAGTGAGTAAT	mesoderm_abdominal_even
CTCCCAATCCGCATAA	mesoderm_abdominal_even
CTCCGATAGAACTGAT	mesoderm_abdominal_even
CTCCGATCAGAGAAAG	mesoderm_abdominal_even
CTCCTCCCACTGGCGT	mesoderm_abdominal_odd
CTCCTTTAGATTAGTG	mesoderm_PS5
CTCCTTTCAGGCAATG	mesoderm_abdominal_even
CTCCTTTTCTTCTAAC	mesoderm_abdominal_odd
CTCGAGGAGTCACACT	mesoderm_abdominal_even
CTCGAGGTCAAGAAAC	mesoderm_abdominal_even
CTCGAGGTCGACTCCT	mesoderm_abdominal_even
CTCTCAGGTTCCAAAC	mesoderm_abdominal_odd
CTCTCAGTCCCTCATG	mesoderm_abdominal_odd
CTCTCGACATAATGCC	mesoderm_abdominal_even
CTCTGGTCAACGACAG	mesoderm_abdominal_even
CTCTGGTGTGTCTTGA	mesoderm_PS5
CTGAATGGTGCACGCT	mesoderm_abdominal_odd
CTGAGGCGTTGGGTAG	mesoderm_abdominal_even
CTGATCCTCGTGCAGC	mesoderm_abdominal_even
CTGCCATGTCTAGATC	mesoderm_PS3
CTGCCATTCGTGGAAG	mesoderm_abdominal_odd
CTGGACGTCAGCGCGT	mesoderm_abdominal_even
CTGGCAGGTGCCCAGT	mesoderm_PS3
CTGGTCTTCCGCTAGG	mesoderm_abdominal_even
CTGTACCAGGTCCAGA	mesoderm_abdominal_odd
CTGTAGAAGCCATCCG	mesoderm_abdominal_even
CTGTAGATCCTTTAGT	mesoderm_abdominal_even
CTGTAGATCGAAATCC	mesoderm_abdominal_even
CTGTATTTCTCTGCCA	mesoderm_PS5
CTGTGGGCAGGACGAT	mesoderm_abdominal_even
CTGTGGGCAGTCTACA	mesoderm_PS3
CTTACCGTCATTCACT	mesoderm_abdominal_odd
CTTAGGACAAGAGGTC	mesoderm_abdominal_odd
CTTAGGATCCTTGACC	mesoderm_PS5
CTTCAATTCTCATGCC	mesoderm_abdominal_odd
CTTCCGACATACTGTG	mesoderm_PS5
CTTCTAAAGCAGCGAT	mesoderm_abdominal_odd
CTTCTAACACCGTCGA	mesoderm_abdominal_odd
CTTCTAAGTCGACTGC	mesoderm_abdominal_even
CTTCTCTTCGTTCTCG	mesoderm_abdominal_even
CTTGAGAAGGCTGGAT	mesoderm_abdominal_even
CTTGAGACAGGTCAGA	mesoderm_PS3
CTTGAGAGTTGCATTG	mesoderm_abdominal_even
CTTGATTCAGTTCCAA	mesoderm_abdominal_odd
CTTGATTCATCCGGTG	mesoderm_abdominal_odd
GAAATGATCATTTCCA	mesoderm_abdominal_even
GAACGTTAGTACAACA	mesoderm_abdominal_even
GAACTGTGTAATGTGA	mesoderm_abdominal_even
GAAGCCCAGCTAATGA	mesoderm_abdominal_even
GAAGCGAAGTCATTGC	mesoderm_abdominal_odd
GAAGGACCATCACGGC	mesoderm_PS5
GAAGTAAAGCTGACTT	mesoderm_abdominal_even
GAAGTAATCAAAGGAT	mesoderm_PS5
GAATCACGTCGCTGCA	mesoderm_abdominal_odd
GACAGCCGTACTGGGA	mesoderm_abdominal_even
GACCAATGTATAGGGC	mesoderm_PS3
GACCCTTCAAGTGATA	mesoderm_abdominal_even
GACCTTCCACGACCTG	mesoderm_abdominal_even
GACCTTCCATCTAGAC	mesoderm_abdominal_even
GACGTTAGTCACGACC	mesoderm_abdominal_even
GACTCTCGTACAATAG	mesoderm_abdominal_even
GACTCTCTCCATTTCA	mesoderm_abdominal_even
GACTGATGTTAATGAG	mesoderm_abdominal_even
GAGAAATAGTAATACG	mesoderm_abdominal_even
GAGACTTTCGCAGTGC	mesoderm_abdominal_even
GAGAGGTAGATCGCTT	mesoderm_abdominal_odd
GAGAGGTAGGCGTTAG	mesoderm_abdominal_odd
GAGAGGTGTTCGTACA	mesoderm_abdominal_odd
GAGATGGTCGGAGCAA	mesoderm_abdominal_even
GAGGCAAAGTAAGACT	mesoderm_abdominal_odd
GAGGGATCACACACGC	mesoderm_abdominal_even
GAGGGATTCATGAGAA	mesoderm_abdominal_even
GAGTCTATCGGCATCG	mesoderm_abdominal_odd
GAGTGAGCACGCCACA	mesoderm_abdominal_odd
GAGTGTTTCGGTAAGG	mesoderm_PS5
GAGTTGTAGGAGTACC	mesoderm_abdominal_even
GATAGCTAGGAGAGGC	mesoderm_abdominal_odd
GATAGCTTCGATAACC	mesoderm_PS5
GATCACAGTAGCTTTG	mesoderm_PS5
GATCAGTGTAACGTTC	mesoderm_PS5
GATCAGTGTCGTGCCA	mesoderm_abdominal_odd
GATCATGGTGTCGATT	mesoderm_abdominal_odd
GATCCCTCAAAGGGTC	mesoderm_abdominal_odd
GATCCCTGTAGCGTTT	mesoderm_abdominal_odd
GATCGTAAGAGCCCAA	mesoderm_abdominal_even
GATGACTTCCGAGTGC	mesoderm_PS3
GATGAGGTCGTGACTA	mesoderm_abdominal_odd
GATGGAGCATCCGAGC	mesoderm_abdominal_even
GATGGAGCATTGGGAG	mesoderm_abdominal_odd
GATGGAGGTATCAAGA	mesoderm_abdominal_odd
GATGTTGGTTGAGGAC	mesoderm_abdominal_even
GATGTTGTCCCGTGAG	mesoderm_abdominal_odd
GATTCGACAAATGAGT	mesoderm_abdominal_odd
GATTCGACAAGTGACG	mesoderm_abdominal_even
GATTCTTTCGAGCCTG	mesoderm_PS5
GATTGGTCACCGCTAG	mesoderm_abdominal_even
GATTGGTGTAGGTCAG	mesoderm_abdominal_even
GATTTCTTCGTCTAAG	mesoderm_PS3
GCAACATAGTGATTCC	mesoderm_abdominal_even
GCAACATGTAGGACCA	mesoderm_abdominal_odd
GCAACCGAGATACTGA	mesoderm_abdominal_odd
GCAACCGCATGGGCAA	mesoderm_abdominal_odd
GCACATAAGCAAGCCA	mesoderm_PS5
GCACATAAGCAGCAGT	mesoderm_PS5
GCACGGTCAGTCAGAG	mesoderm_abdominal_even
GCACTAAAGTGGATTA	mesoderm_abdominal_even
GCACTAACAGTCCCGA	mesoderm_abdominal_even
GCAGCTGAGTCTTCGA	mesoderm_abdominal_odd
GCAGCTGCAAGTCATC	mesoderm_abdominal_odd
GCAGCTGCAATACGAA	mesoderm_abdominal_odd
GCAGCTGCACGCGTGT	mesoderm_abdominal_even
GCAGCTGGTCATCTAG	mesoderm_abdominal_even
GCATCTCCAAATCAGA	mesoderm_PS3
GCATTAGCAGTAGTGG	mesoderm_abdominal_even
GCATTAGCATTCTCTA	mesoderm_PS5
GCCAACGGTTGCATAC	mesoderm_abdominal_odd
GCCAGCAAGAACAAGG	mesoderm_abdominal_odd
GCCAGCACATGGAAGC	mesoderm_abdominal_even
GCCAGCAGTTGGTACT	mesoderm_abdominal_odd
GCCAGGTCAGTTTGGT	mesoderm_abdominal_odd
GCCAGGTTCCCAATAG	mesoderm_abdominal_odd
GCCAGTGAGCAATAAC	mesoderm_abdominal_even
GCCAGTGTCAGCAATC	mesoderm_abdominal_odd
GCCAGTGTCTCTGCCA	mesoderm_PS5
GCCCAGAGTGTAAATG	mesoderm_abdominal_even
GCCCGAAGTCTTGAGT	mesoderm_PS5
GCCTGTTCAGTCGCTG	mesoderm_PS5
GCCTGTTTCTCTTCAA	mesoderm_abdominal_odd
GCGAGAAAGATAGTCA	mesoderm_abdominal_even
GCGAGAATCGCGGTAC	mesoderm_abdominal_odd
GCGATCGGTCCTTGTC	mesoderm_PS5
GCGGATCTCCGTATGA	mesoderm_abdominal_odd
GCGTTTCAGAGGGTCT	mesoderm_abdominal_even
GCTACAAAGAGGCCAT	mesoderm_abdominal_odd
GCTACCTTCAGGGTAG	mesoderm_abdominal_even
GCTGAATGTCTCAAGT	mesoderm_abdominal_even
GCTGGGTGTGGTCAAG	mesoderm_abdominal_odd
GCTTCACCATCTCATT	mesoderm_abdominal_odd
GCTTTCGCAGCCCACA	mesoderm_abdominal_even
GCTTTCGTCTAGTACG	mesoderm_PS5
GGAAGTGTCCGTCCTA	mesoderm_abdominal_even
GGAATCTGTAACCAGG	mesoderm_abdominal_even
GGAATGGTCTCAGTCC	mesoderm_abdominal_even
GGACGTCAGATTTGCC	mesoderm_abdominal_odd
GGAGAACGTGACTCGC	mesoderm_abdominal_even
GGAGATGCACGACAAG	mesoderm_abdominal_even
GGAGCAAGTGTACAGG	mesoderm_abdominal_even
GGAGGATGTAATGATG	mesoderm_abdominal_even
GGAGGATTCTACCCAC	mesoderm_abdominal_even
GGAGGTATCTATCGCC	mesoderm_abdominal_even
GGATGTTAGTCAACAA	mesoderm_PS5
GGATGTTAGTGCACCC	mesoderm_abdominal_even
GGATGTTCAAGGACAC	mesoderm_abdominal_odd
GGATGTTGTCCATAGT	mesoderm_abdominal_even
GGCACGTAGTGCCAGA	mesoderm_abdominal_even
GGCACGTCAAACTCGT	mesoderm_abdominal_odd
GGCGTCACACACCAGC	mesoderm_PS5
GGCGTCATCCCGTGTT	mesoderm_PS5
GGCTTGGAGATGCTTC	mesoderm_PS3
GGCTTTCCAATTGCTG	mesoderm_abdominal_even
GGGAAGTAGGCCCACT	mesoderm_abdominal_even
GGGACAAAGATGCAGC	mesoderm_abdominal_even
GGGATCCTCCTTCTGG	mesoderm_abdominal_odd
GGGATGACACTTTATC	mesoderm_abdominal_even
GGGCCATCAAGTGGCA	mesoderm_abdominal_odd
GGGCCATGTCCAGCGT	mesoderm_abdominal_odd
GGGCCATTCGTTAGTG	mesoderm_abdominal_even
GGGCTCACAGCGACCT	mesoderm_PS5
GGGTAGACAATAACCC	mesoderm_abdominal_even
GGGTAGAGTATCGAGG	mesoderm_PS5
GGGTATTCACCCTAAA	mesoderm_PS3
GGGTCACAGATACATG	mesoderm_abdominal_odd
GGGTCTGTCGTGCGAC	mesoderm_abdominal_even
GGGTGTCAGCTGAAAT	mesoderm_abdominal_even
GGGTGTCTCTGTGCAA	mesoderm_abdominal_odd
GGGTTATCAATCCTAG	mesoderm_abdominal_odd
GGGTTTAAGCGGTAAC	mesoderm_abdominal_even
GGTAGAGCACGGATCC	mesoderm_PS5
GGTGAAGAGTCCGCGT	mesoderm_PS5
GGTGTCGAGTCACTAC	mesoderm_abdominal_even
GGTGTCGGTGTCCAAT	mesoderm_abdominal_odd
GGTGTCGTCGGAGCAA	mesoderm_PS5
GGTGTTAAGCTTCTAG	mesoderm_abdominal_odd
GGTGTTAGTCTAGTGT	mesoderm_abdominal_even
GGTGTTAGTTTGTTGG	mesoderm_abdominal_even
GGTGTTATCACTTATC	mesoderm_PS3
GTAACCACAAACACGG	mesoderm_abdominal_even
GTAAGTCGTCTCTCCA	mesoderm_abdominal_even
GTAAGTCGTGCAACAG	mesoderm_PS3
GTAATCGGTCTTGTCC	mesoderm_abdominal_odd
GTACAACCACATTCGA	mesoderm_abdominal_odd
GTACAGTAGTGTACCT	mesoderm_abdominal_even
GTACAGTGTGAACTAA	mesoderm_PS5
GTACAGTTCGGAGTAG	mesoderm_PS3
GTAGAAAAGGAGAGTA	mesoderm_PS5
GTAGAAAAGTTGCTCA	mesoderm_abdominal_even
GTAGAAAGTCGGAAAC	mesoderm_abdominal_odd
GTAGATCCATCACCAA	mesoderm_abdominal_odd
GTAGCTACACTGGCGT	mesoderm_abdominal_odd
GTAGCTAGTCAAACGG	mesoderm_abdominal_odd
GTAGCTATCGCAGTTA	mesoderm_abdominal_odd
GTAGGAGAGCGTACAG	mesoderm_abdominal_odd
GTATTGGAGTCTGTAC	mesoderm_abdominal_odd
GTATTGGCAATGTCTG	mesoderm_abdominal_odd
GTATTTCAGAGCTGAC	mesoderm_abdominal_odd
GTCAAGTGTAACCAGG	mesoderm_abdominal_even
GTCAAGTGTGCCCAGT	mesoderm_abdominal_odd
GTCAAGTTCCACTAGA	mesoderm_abdominal_even
GTCACGGAGCTAGTTC	mesoderm_abdominal_even
GTCACTCAGACCTCAT	mesoderm_PS3
GTCACTCTCTGCGAGC	mesoderm_abdominal_even
GTCAGCGCATACTGTG	mesoderm_abdominal_odd
GTCATGACAGAGCCCT	mesoderm_abdominal_even
GTCATGACATTGACTG	mesoderm_abdominal_odd
GTCATGATCGCAAGAG	mesoderm_abdominal_even
GTCATTTCAGAAACCG	mesoderm_abdominal_odd
GTCATTTTCAAACGAA	mesoderm_abdominal_even
GTCATTTTCATTGCCC	mesoderm_abdominal_odd
GTCATTTTCTGTGCTC	mesoderm_abdominal_even
GTCCACTCAGGTGGAT	mesoderm_abdominal_odd
GTCCACTTCAAGGTGG	mesoderm_abdominal_even
GTCCCATGTAGACGGT	mesoderm_abdominal_even
GTCCCATTCTCGCCTA	mesoderm_abdominal_odd
GTCCTCACACGCAAAG	mesoderm_abdominal_odd
GTCCTCACATCCGAAT	mesoderm_abdominal_odd
GTCCTCACATGGAAGC	mesoderm_abdominal_even
GTCCTCAGTCCCAAAT	mesoderm_abdominal_even
GTCGAATCAGGCATGA	mesoderm_PS3
GTCGCGAAGACCCGCT	mesoderm_abdominal_odd
GTCGCGAGTGACCTGC	mesoderm_abdominal_odd
GTCGTAAAGTAGTCTC	mesoderm_PS5
GTCTAGACAAACCGGA	mesoderm_abdominal_odd
GTCTAGACATGGAATA	mesoderm_PS5
GTCTGTCGTTGTCAGT	mesoderm_abdominal_odd
GTCTTTAAGTAAATGC	mesoderm_abdominal_even
GTGACGCGTACTAGCT	mesoderm_abdominal_even
GTGACGCTCGGAGATG	mesoderm_PS3
GTGAGGACACGGCCAT	mesoderm_abdominal_even
GTGAGGAGTAGCTGTT	mesoderm_abdominal_odd
GTGAGTTAGGAAACGA	mesoderm_abdominal_even
GTGATGTCAACAAAGT	mesoderm_PS5
GTGATGTCACTCGATA	mesoderm_PS3
GTGATGTCATGACGAG	mesoderm_abdominal_even
GTGATGTCATTGTCGA	mesoderm_PS5
GTGATGTGTCTAGATC	mesoderm_abdominal_odd
GTGCACGCAGCTTTGA	mesoderm_abdominal_odd
GTGCACGTCCATGCAA	mesoderm_abdominal_even
GTGCAGCGTGCTCTCT	mesoderm_abdominal_odd
GTGCGTGCAACGGCCT	mesoderm_PS3
GTGCTGGCAATACCTG	mesoderm_PS5
GTGCTGGCAGTGGGTA	mesoderm_abdominal_even
GTGCTGGGTGACTAAA	mesoderm_abdominal_odd
GTGCTGGGTGAGTGAC	mesoderm_abdominal_odd
GTGCTGGTCTCTCTTC	mesoderm_abdominal_even
GTGGAAGTCAATCAGC	mesoderm_abdominal_even
GTGGAAGTCCCGATCT	mesoderm_abdominal_odd
GTGGAAGTCCTCGATC	mesoderm_abdominal_odd
GTGGAGAAGTCGGGAT	mesoderm_abdominal_even
GTGGAGACAGTCGTTA	mesoderm_abdominal_even
GTGGAGAGTAATACCC	mesoderm_PS3
GTGGCGTCATCATCTT	mesoderm_abdominal_even
GTGGGAAAGGTAGATT	mesoderm_abdominal_even
GTGGTTAGTCTACAGT	mesoderm_PS5
GTGTGATCACCGTCTT	mesoderm_abdominal_even
GTGTGATGTTCTCTAT	mesoderm_abdominal_odd
GTGTGGCAGAATAACC	mesoderm_abdominal_even
GTGTGGCAGGAACGTC	mesoderm_PS3
GTGTTAGCAGATTTCG	mesoderm_abdominal_odd
GTGTTCCAGAAATCCA	mesoderm_abdominal_odd
GTGTTCCCACCTGAAT	mesoderm_abdominal_odd
GTTACAGCAGCGCGTT	mesoderm_abdominal_even
GTTACCCAGTCGAATA	mesoderm_PS3
GTTACCCTCCTACCGT	mesoderm_abdominal_even
GTTACGAGTTGGTGTT	mesoderm_PS5
GTTAGACCAATTCTCT	mesoderm_abdominal_even
GTTCATTTCATGCAGT	mesoderm_PS3
GTTCCGTAGGTTGGTG	mesoderm_abdominal_odd
GTTCCGTGTTAACCTG	mesoderm_PS3
GTTCCGTGTTCCATTT	mesoderm_abdominal_odd
GTTCCGTGTTCGTAAC	mesoderm_abdominal_odd
GTTCGCTTCGGTCGGT	mesoderm_abdominal_odd
GTTCTATCACCCTTAC	mesoderm_abdominal_odd
GTTGTAGGTTGAAGTA	mesoderm_abdominal_odd
GTTGTCCGTGGATCGA	mesoderm_abdominal_even
GTTGTCCTCGTCAAAC	mesoderm_abdominal_odd
GTTTGGATCGAAGTGG	mesoderm_abdominal_odd
TAACACGGTCTCGGGT	mesoderm_PS5
TAACACGGTTCGGCGT	mesoderm_abdominal_odd
TAACCAGAGTGCTAGG	mesoderm_abdominal_even
TAACGACCACGCTATA	mesoderm_abdominal_odd
TAACTTCCATTCACAG	mesoderm_abdominal_odd
TAAGCCACACAGTCAT	mesoderm_PS5
TAATCTCTCATCTGTT	mesoderm_abdominal_even
TAATCTCTCTTGGTCC	mesoderm_PS3
TAATTCCCATCGGCCA	mesoderm_abdominal_odd
TAATTCCTCGATTCCC	mesoderm_PS5
TAATTCCTCGGTGCAC	mesoderm_abdominal_odd
TACACCCAGATGATTG	mesoderm_PS5
TACACCCGTTCTCTAT	mesoderm_abdominal_odd
TACAGGTCAAGAGCTG	mesoderm_abdominal_even
TACCGAACAGTCCGTG	mesoderm_abdominal_odd
TACCGGGAGTACTCGT	mesoderm_abdominal_odd
TACCGGGCACCAGACC	mesoderm_abdominal_odd
TACCTGCTCTCCGAAA	mesoderm_abdominal_odd
TACGGGCAGAGATTCA	mesoderm_PS5
TACGGGCCATTGGATC	mesoderm_PS5
TACGGGCTCCCATTTA	mesoderm_abdominal_odd
TACGGTAGTGCTCTCT	mesoderm_abdominal_even
TACGTCCCATCCGAGC	mesoderm_PS5
TACTGCCAGACCTGGA	mesoderm_abdominal_odd
TACTGCCCACATGGTT	mesoderm_abdominal_odd
TACTGCCTCCAAGAGG	mesoderm_abdominal_odd
TACTTACGTCTGCGCA	mesoderm_abdominal_even
TACTTACGTGTGATGG	mesoderm_PS5
TACTTCACACAGAGAC	mesoderm_abdominal_even
TACTTGTCACGACAAG	mesoderm_abdominal_odd
TAGACCAAGCGTATAA	mesoderm_PS5
TAGACTGAGAACAAGG	mesoderm_abdominal_even
TAGACTGGTCTACATG	mesoderm_abdominal_even
TAGATCGAGCGTGCCT	mesoderm_abdominal_odd
TAGATCGCATAGGAGC	mesoderm_abdominal_odd
TAGCACAGTAGCACAG	mesoderm_abdominal_odd
TAGGAGGAGACCAAAT	mesoderm_PS5
TAGGAGGCATCTCGTC	mesoderm_PS3
TAGGAGGTCCGCACTT	mesoderm_abdominal_odd
TAGGAGGTCCTTGACC	mesoderm_abdominal_even
TAGGGTTAGATCGACG	mesoderm_PS3
TAGGGTTAGCACACCC	mesoderm_abdominal_even
TAGGTACAGATGATTG	mesoderm_abdominal_even
TAGGTACGTTGACTAC	mesoderm_abdominal_even
TAGGTTGGTCCCTCAT	mesoderm_PS3
TAGGTTGTCGAACGCC	mesoderm_abdominal_odd
TATACCTTCCATACAG	mesoderm_PS5
TATATCCGTCATGACT	mesoderm_PS5
TATCAGGGTCCACACG	mesoderm_abdominal_even
TATCTGTGTTGTGGCC	mesoderm_abdominal_odd
TATCTTGCAGCGACCT	mesoderm_abdominal_even
TATCTTGGTATGTCAC	mesoderm_abdominal_even
TATCTTGTCGTGCAGC	mesoderm_abdominal_even
TATGTTCCAGTGGTGA	mesoderm_abdominal_odd
TATTCCAAGGTAGACC	mesoderm_PS5
TATTCCAAGTAGTCTC	mesoderm_PS5
TATTGCTAGTTGCATC	mesoderm_abdominal_even
TATTGGGCAAGGCCTC	mesoderm_PS3
TATTGGGTCCGCTTAC	mesoderm_abdominal_even
TCAAGACAGAAGTGTT	mesoderm_abdominal_even
TCAAGACCATATTCGG	mesoderm_abdominal_odd
TCAATTCTCTAGGCAT	mesoderm_abdominal_odd
TCACAAGTCGACATTG	mesoderm_abdominal_even
TCACATTGTAATTGGA	mesoderm_abdominal_odd
TCACGCTTCGGTGTTA	mesoderm_abdominal_even
TCACGGGTCTCGGGAC	mesoderm_abdominal_odd
TCACTATCATGGCGCT	mesoderm_abdominal_odd
TCACTCGAGCTCAGAG	mesoderm_abdominal_even
TCACTCGAGGTTCTTG	mesoderm_abdominal_even
TCACTCGAGTTGCGAG	mesoderm_abdominal_odd
TCACTCGTCACAGTGT	mesoderm_abdominal_odd
TCAGCAAAGTTAACAG	mesoderm_abdominal_even
TCAGCAACAAGGCAAC	mesoderm_abdominal_even
TCAGCAATCCATCTGC	mesoderm_abdominal_odd
TCAGCCTGTGCCTAAT	mesoderm_PS3
TCAGGGCAGCATGGGT	mesoderm_abdominal_even
TCAGGGCAGCTCCCTT	mesoderm_PS5
TCAGTCCAGTTTGCTG	mesoderm_PS3
TCAGTGATCATCTCTA	mesoderm_abdominal_even
TCAGTGATCCCGTGTT	mesoderm_abdominal_even
TCATGAGAGAACAGGA	mesoderm_abdominal_odd
TCATGAGAGGAGAGTA	mesoderm_PS5
TCATGAGAGTTTCGAC	mesoderm_PS5
TCATGAGTCTCAGAAC	mesoderm_abdominal_odd
TCATGGAAGTGCCCGT	mesoderm_abdominal_odd
TCATGGACACCAGTAT	mesoderm_abdominal_even
TCATGGACATTCGGGC	mesoderm_abdominal_odd
TCATGGATCTGCCCTA	mesoderm_abdominal_odd
TCATGTTCAAGGAGTC	mesoderm_abdominal_even
TCATTACAGGCGTCCT	mesoderm_abdominal_even
TCATTCATCATACAGC	mesoderm_abdominal_odd
TCATTGTCAAAGCTAA	mesoderm_abdominal_even
TCATTGTGTCACGACC	mesoderm_abdominal_odd
TCATTTGCAGGGTTGA	mesoderm_abdominal_even
TCCACCAAGGGTTGCA	mesoderm_abdominal_even
TCCATGCGTGAGGATC	mesoderm_abdominal_odd
TCCCACAAGCGGGTTA	mesoderm_abdominal_even
TCCCACAGTACAGTAA	mesoderm_abdominal_odd
TCCCAGTAGCTAGAAT	mesoderm_abdominal_odd
TCCGAAAGTGACAGGT	mesoderm_abdominal_odd
TCCGGGAGTACTCGCG	mesoderm_abdominal_odd
TCCGGGATCGACCACG	mesoderm_abdominal_odd
TCCTCGAGTCGACTTA	mesoderm_PS3
TCCTCTTCACAAAGCG	mesoderm_abdominal_odd
TCCTCTTCACAGTGAG	mesoderm_abdominal_odd
TCCTCTTGTGTGTCCG	mesoderm_abdominal_even
TCCTGCAAGCATTTGC	mesoderm_PS5
TCCTGCACAATACAGA	mesoderm_abdominal_odd
TCCTTCTAGTCAGAGC	mesoderm_abdominal_odd
TCCTTTCGTGGCTGCT	mesoderm_abdominal_even
TCGAACACACGCTATA	mesoderm_abdominal_odd
TCGAACAGTTGTTGAC	mesoderm_PS5
TCGAAGTAGAACAAGG	mesoderm_abdominal_odd
TCGACCTCAGGCATTT	mesoderm_PS3
TCGACCTGTCTACGAT	mesoderm_PS5
TCGCACTCAGCGAGTA	mesoderm_abdominal_odd
TCGCTTGTCCTATTGT	mesoderm_abdominal_odd
TCGGATAGTCACTCGG	mesoderm_abdominal_even
TCGGGACAGTTGCTCA	mesoderm_abdominal_even
TCGGGACCAGTGGGTA	mesoderm_abdominal_even
TCGGGACCATGCACTA	mesoderm_abdominal_odd
TCGGGACTCGGACAAG	mesoderm_abdominal_odd
TCGGGCAAGCTTGTTG	mesoderm_PS5
TCGGGCATCTGCCTGT	mesoderm_PS5
TCGGGTGAGAGAACCC	mesoderm_abdominal_even
TCGGGTGGTATGTCAC	mesoderm_PS5
TCGGTCTAGAAACTCA	mesoderm_abdominal_even
TCGGTCTTCTCCGAAA	mesoderm_abdominal_odd
TCGTCCACAATACAGA	mesoderm_abdominal_even
TCGTCCACAGACGGAT	mesoderm_abdominal_even
TCGTGGGGTAATCAGA	mesoderm_abdominal_odd
TCGTGGGGTCTTAGTG	mesoderm_abdominal_odd
TCTAACTCACTACACA	mesoderm_abdominal_even
TCTAACTTCGCAACAT	mesoderm_abdominal_odd
TCTACATGTACAAACA	mesoderm_abdominal_even
TCTCCGAGTCATGCAT	mesoderm_PS5
TCTCTGGAGAGCATTA	mesoderm_abdominal_even
TCTCTGGAGTCATGAA	mesoderm_abdominal_odd
TCTGCCATCGCCACTT	mesoderm_abdominal_even
TCTGGCTAGTTCCATG	mesoderm_abdominal_odd
TCTTAGTTCGAGAAAT	mesoderm_abdominal_odd
TCTTCCTAGTGGACTG	mesoderm_abdominal_odd
TCTTCCTTCTTCTCAA	mesoderm_abdominal_odd
TCTTGCGCAGCTCTGG	mesoderm_abdominal_odd
TCTTGCGGTATTCTCT	mesoderm_abdominal_odd
TCTTTGACAGTCAGCC	mesoderm_abdominal_even
TGAATCGAGCGTGCCT	mesoderm_abdominal_even
TGAATCGGTCGAAGCA	mesoderm_abdominal_odd
TGACAGTAGAGAAGGT	mesoderm_abdominal_even
TGACAGTCAGCACGAA	mesoderm_abdominal_odd
TGACCCTTCGGTCGGT	mesoderm_abdominal_odd
TGACGCGCACCAGGTC	mesoderm_abdominal_even
TGACGCGGTTGCACGC	mesoderm_PS3
TGACTCCTCGAGTCCG	mesoderm_PS5
TGAGACTTCCTCTAGC	mesoderm_abdominal_even
TGAGCATCACACGTGC	mesoderm_abdominal_even
TGAGGAGCATACTTTC	mesoderm_abdominal_odd
TGAGGGACAACGTTAC	mesoderm_abdominal_even
TGAGGGACACACACGC	mesoderm_PS3
TGAGGGACACGTCATA	mesoderm_abdominal_even
TGAGGTTTCAGCTCTC	mesoderm_abdominal_even
TGATCAGAGACATCCT	mesoderm_abdominal_even
TGATCTTTCGCTAAAC	mesoderm_PS3
TGATGCATCAAAGACA	mesoderm_abdominal_odd
TGATTCTCAGCTCGGT	mesoderm_PS3
TGATTCTTCCCGTAAA	mesoderm_abdominal_even
TGATTTCAGCGAACTG	mesoderm_abdominal_odd
TGCACGGCAATAGAGT	mesoderm_PS5
TGCAGTACATGGCGCT	mesoderm_abdominal_odd
TGCAGTAGTACCGGCT	mesoderm_abdominal_even
TGCGATAAGGGTCTTT	mesoderm_PS5
TGCGGCACAATACGAA	mesoderm_PS5
TGCGGCACAATTGCCA	mesoderm_abdominal_even
TGCTCCAAGACAAGCC	mesoderm_abdominal_odd
TGCTCGTAGTGACACG	mesoderm_abdominal_even
TGCTCGTCACAAGCTT	mesoderm_abdominal_odd
TGCTTCGCAACTGCCG	mesoderm_PS5
TGCTTGCGTGAAGCGT	mesoderm_abdominal_odd
TGCTTGCTCAAAGGAT	mesoderm_PS3
TGGAACTCATACCATG	mesoderm_abdominal_even
TGGAACTTCGTGCACG	mesoderm_abdominal_even
TGGAGAGTCTGATGGT	mesoderm_abdominal_odd
TGGATCACAGTTGGTT	mesoderm_abdominal_even
TGGATCAGTCGTAATC	mesoderm_PS5
TGGATCATCACCACAA	mesoderm_abdominal_even
TGGATGTTCTTGCAGA	mesoderm_abdominal_odd
TGGCGTGGTAGTGTGG	mesoderm_abdominal_odd
TGGGTTACATGAGGGT	mesoderm_abdominal_odd
TGGGTTAGTTTCGATG	mesoderm_abdominal_even
TGGTACAAGTGGCCTC	mesoderm_abdominal_even
TGGTAGTAGCCTCAAT	mesoderm_abdominal_even
TGGTAGTGTTGATCGT	mesoderm_abdominal_even
TGGTAGTTCCAGCCTT	mesoderm_abdominal_even
TGGTTAGGTACATTGC	mesoderm_abdominal_even
TGGTTAGGTTAAGGAT	mesoderm_abdominal_odd
TGGTTAGGTTACGATC	mesoderm_PS5
TGTAACGAGCAAATCA	mesoderm_abdominal_even
TGTACAGGTCGCATCG	mesoderm_abdominal_even
TGTACAGTCTGCTTAT	mesoderm_abdominal_odd
TGTAGACCAATGGGTG	mesoderm_abdominal_even
TGTAGACTCTCGTTTA	mesoderm_abdominal_odd
TGTCCACTCGACACCG	mesoderm_abdominal_odd
TGTCCCAAGGTGGGTT	mesoderm_abdominal_odd
TGTCCTGAGCTGTTCA	mesoderm_PS5
TGTCCTGCACAATGAA	mesoderm_abdominal_odd
TGTCCTGGTCACTAGT	mesoderm_PS5
TGTCCTGTCCTTATGT	mesoderm_abdominal_even
TGTGAGTAGAAATTCG	mesoderm_abdominal_odd
TGTGATGAGTCCCGGT	mesoderm_abdominal_even
TGTGATGCACTCGATA	mesoderm_abdominal_even
TGTGCGGAGGCTCTAT	mesoderm_abdominal_odd
TGTGGCGAGCGCCTTG	mesoderm_abdominal_odd
TGTTCATGTTAAGCAA	mesoderm_PS5
TGTTCCGCAAGACAAT	mesoderm_abdominal_even
TGTTCCGCATCGCTAA	mesoderm_PS3
TGTTCCGGTCGGAACA	mesoderm_abdominal_odd
TGTTGAGGTAAGATTG	mesoderm_abdominal_odd
TGTTGGAAGTAACCTC	mesoderm_abdominal_even
TGTTGGACAGCCGTTG	mesoderm_abdominal_odd
TGTTGGATCTCACGAA	mesoderm_PS5
TGTTTGTGTCGAGCTC	mesoderm_abdominal_even
TTAATCCCAGCTGTCG	mesoderm_abdominal_odd
TTACCATCATGTACGT	mesoderm_abdominal_odd
TTACCATGTTAAACAG	mesoderm_abdominal_even
TTACCATTCTTGAACG	mesoderm_abdominal_even
TTACGTTAGCTGACCC	mesoderm_abdominal_odd
TTACGTTGTCGAATTC	mesoderm_abdominal_even
TTACGTTTCTCATGCC	mesoderm_abdominal_even
TTACTGTCACGCAAAG	mesoderm_PS3
TTACTGTCACGTATAC	mesoderm_abdominal_even
TTAGGCAAGATTCGCT	mesoderm_PS5
TTAGTCTAGGGAGAAT	mesoderm_abdominal_odd
TTCAATCCAACCACGC	mesoderm_abdominal_even
TTCACGCTCATGCCCT	mesoderm_abdominal_even
TTCAGGACATGTGGTT	mesoderm_PS3
TTCCACGTCAGGGTAG	mesoderm_abdominal_odd
TTCCGTGCATAGAATG	mesoderm_PS5
TTCCGTGTCGCTCTCA	mesoderm_abdominal_even
TTCCTAAGTTCTTAGG	mesoderm_abdominal_odd
TTCCTTCAGAATTGCA	mesoderm_abdominal_even
TTCCTTCAGTGATGGC	mesoderm_abdominal_even
TTCCTTCCACCTCTGT	mesoderm_abdominal_odd
TTCCTTCCATCCGGTG	mesoderm_abdominal_odd
TTCGCTGCATCATCCC	mesoderm_abdominal_even
TTCGGTCCACTATGTG	mesoderm_PS3
TTCGGTCCAGCAGTAG	mesoderm_abdominal_odd
TTCTAGTGTGCACAAG	mesoderm_abdominal_even
TTCTGTACACCGGAAA	mesoderm_abdominal_odd
TTCTGTAGTATCAAGA	mesoderm_abdominal_odd
TTCTTCCCAGCGAACA	mesoderm_abdominal_even
TTCTTGAAGTCAGCCC	mesoderm_abdominal_odd
TTCTTGATCATCGCTC	mesoderm_PS5
TTGAACGCAACTGTGT	mesoderm_abdominal_odd
TTGAACGGTTTCGTTT	mesoderm_abdominal_odd
TTGCGTCAGTCATGAA	mesoderm_abdominal_even
TTGCTGCAGTCAGAGC	mesoderm_PS5
TTGCTGCGTAGGTGCA	mesoderm_abdominal_even
TTGGATGGTACGCTTA	mesoderm_abdominal_odd
TTGGGATAGGCACAAC	mesoderm_abdominal_odd
TTGGGATAGTAAACGT	mesoderm_PS5
TTGGGTAAGATCGCCC	mesoderm_abdominal_odd
TTGGGTAAGGTAACTA	mesoderm_abdominal_even
TTGGGTATCTCCTGAC	mesoderm_abdominal_even
TTGTGGAAGCTATCCA	mesoderm_abdominal_odd
TTGTGTTCAAGTCGTT	mesoderm_abdominal_even
TTGTGTTGTCGCAACC	mesoderm_abdominal_odd
TTGTGTTGTGGCAGAT	mesoderm_abdominal_odd
TTGTTGTCAAGATGTA	mesoderm_PS3
TTGTTTGAGTCCGCGT	mesoderm_abdominal_even
TTGTTTGTCGTTCAGA	mesoderm_abdominal_even
TTTATGCTCTGAATCG	mesoderm_abdominal_odd
TTTCAGTAGGCCTAGA	mesoderm_abdominal_even
TTTCATGAGAGATCGC	mesoderm_abdominal_odd
TTTCATGCAGTTGTCA	mesoderm_abdominal_odd
TTTCATGCATGAGTAA	mesoderm_abdominal_odd
TTTCATGTCAATGTCG	mesoderm_abdominal_even
TTTGACTGTCTGTTAG	mesoderm_abdominal_odd
TTTGATCCATGATGCT	mesoderm_abdominal_odd
TTTGATCGTCCTGGTG	mesoderm_abdominal_even
TTTGGAGCACGCGCAT	mesoderm_abdominal_even
TTTGGAGTCTCAACGA	mesoderm_abdominal_even
